device_id,carrier,rx_bytes_wifi,tx_bytes_wifi,rx_bytes_mobile,tx_bytes_mobile,total_used_bytes,extract_date
3108cb2a706ce235,,46928815789,686867653,0,0,47615683442,2022-10-31
dac996594635df76,t-mobile,17500516856,340118485,72699,23539,17840731579,2022-10-31
14199cbb999f421b,t-mobile,0,0,0,0,0,2022-10-31
c85185f13742d91d,t-mobile,10351921248,243958978,50969,15896,10595947091,2022-10-31
f501885536dfd68f,,563046699,51956971,0,0,615003670,2022-10-31
632a12f6d7ad49e7,mint,606692,178785,26916,8514,820907,2022-10-31
fb1a4374211a7ee6,Verizon ,0,0,0,0,0,2022-10-31
6ee47514f64610bf,,94197071,1382597,110939683,1928152,208447503,2022-10-31
55fda8a2614b8153,verizon ,0,0,0,0,0,2022-10-31
135d333c7eeed882,verizon ,0,0,0,0,0,2022-10-31
01a43c477f9ff706,,1593687980,70413984,0,0,1664101964,2022-10-31
1ba858a7db102881,tbaytel / rogers,740579736,65634855,6467,2171,806223229,2022-10-31
4d3c9eb0b6f8d4a1,,196415,59805,0,0,256220,2022-10-31
7b1065e760edddd4,,79452606,1597735,0,4920,81055261,2022-10-31
d4b914751a8bbd58,t-mobile,3318782897,66931005,666541,50826,3386431269,2022-10-31
2f923ede562d302b,public mobile,0,0,0,0,0,2022-10-31
82f6534aa29c71ba,t-mobile,0,0,0,0,0,2022-10-31
2b477fb04a2904b5,mint,40491206943,735838646,742581,83142,41227871312,2022-10-31
45c1eebf3f4490b3,t-mobile,365798635,10029211,270396,86615,376184857,2022-10-31
118921a556c2b4c8,,802060338,12570228,0,0,814630566,2022-10-31
ad73cf31b0d918d1,t-mobile,484464491,19647277,0,0,504111768,2022-10-31
70e578eb6d9add99,mint,9170392912,162748192,6646,2056,9333149806,2022-10-31
1775f6a8a0603346,,333398069,5931388,135677431,2797544,477804432,2022-10-31
f3609b88fd6a4829,t-mobile,1044584763,72193838,146397,62568,1116987566,2022-10-31
c7d8af53af5357fe,t-mobile,0,0,0,0,0,2022-10-31
584bbccaa406b325,at&t,35428,174067,573893,161852,945240,2022-10-31
0e2ccb1e6b4bcf39,t-mobile,0,0,0,0,0,2022-10-31
c30fcaf461572deb,t-mobile,0,0,0,0,0,2022-10-31
0ec43843993443e6,t-mobile,0,0,0,0,0,2022-10-31
21daaf8b7cf417da,ting,878126941,48613823,172345,48076,926961185,2022-10-31
e6a44228ad831e63,t-mobile,0,0,0,0,0,2022-10-31
d1b929cd8aed0bde,t-mobile,0,0,0,0,0,2022-10-31
6dc0d304bbb9d8ce,,982368928,19213491,0,0,1001582419,2022-10-31
4eb4abf659c7d171,t-mobile,170947,53401,1037109,328257,1589714,2022-10-31
e039cbeaa29be3ca,t-mobile,831461,240628,0,0,1072089,2022-10-31
f56c710ed189fc78,t-mobile,710776,269615,236407,98276,1315074,2022-10-31
6f3137126324eec0,,175472576,3573348,0,0,179045924,2022-10-31
8519ec13be9a46bc,t-mobile,100082475,1971972,479818,172565,102706830,2022-10-31
2d14e942f6e9ff6a,t-mobile,880687,233823,0,0,1114510,2022-10-31
0095c1fad1768fa0,t-mobile,848423,296130,122203,43505,1310261,2022-10-31
5d315ee40e0336b3,,1216123743,21908718,0,0,1238032461,2022-10-31
33dfc7468c5c2f3e,verizon wireless,0,0,0,0,0,2022-10-31
130d15be838879af,,734290,226865,99739,22870,1083764,2022-10-31
c27ce5dabfebcb11,t-mobile,0,0,0,0,0,2022-10-31
109fae7307947ecc,,634187,177517,85141,26439,923284,2022-10-31
a315128101733b75,verizon ,0,0,1036377,421111,1457488,2022-10-31
2816d02054794103,t-mobile,20155952,2146817,575304,210407,23088480,2022-10-31
5ef249c0e335a4ba,,838494474,23923712,0,0,862418186,2022-10-31
9bd44f7259369532,verizon ,6895726340,166845494,0,0,7062571834,2022-10-31
64cb9c48084b4d8f,,596720087,10108331,0,0,606828418,2022-10-31
0e385adbf48f6119,,843951993,22871732,0,0,866823725,2022-10-31
6457bb48ba0b683a,mint,9724859436,225798998,807108,114451,9951579993,2022-10-31
11d7701e36e27719,t-mobile,0,0,0,0,0,2022-10-31
c3d4100bf98172f3,,573039761,62196177,954231,47788,636237957,2022-10-31
6e2101ec95d6256f,,172718962,2793136,0,0,175512098,2022-10-31
15e131b013793fdf,at&t,380529,128860,43395004,1630348,45534741,2022-10-31
278a681aaf738957,t-mobile,0,0,1027050,187073,1214123,2022-10-31
d448d39513604ef3,t-mobile,0,0,969708,150532,1120240,2022-10-31
d69b336bb4a0efda,,413797320,68611303,53539,24428,482486590,2022-10-31
cc8db6d7f048dfab,t-mobile,759822,209263,364482,106518,1440085,2022-10-31
c8c952c4e40682c3,verizon ,41040370,765562,1174167,297081,43277180,2022-10-31
05065940326c5665,,761181,253300,29678,8906,1053065,2022-10-31
686b32041872de1c,t-mobile,321324357,7747775,2155444,356863,331584439,2022-10-31
1910dc7bf5f5eb8d,,8425,1832,0,0,10257,2022-10-31
e1b15695069ff7fa,t-mobile,0,0,29890,8354,38244,2022-10-31
12d302b3db9ae7b0,gsma,866046,279612,0,0,1145658,2022-10-31
3486ed0d399eb82b,verizon ,0,0,234650,244617,479267,2022-10-31
3b99e9d1a8215f66,t-mobile,1834743273,51339134,1846820,336074,1888265301,2022-10-31
75c8cb9fb5012b4b,mint,311773062,37207507,541797,51451,349573817,2022-10-31
28580d879a525dc5,t-mobile,778438,276351,7119,2127,1064035,2022-10-31
c8fba04da1a282b9,mint,848087,230311,61937,19553,1159888,2022-10-31
331482cc9310eb57,mint,810330728,66852128,480827,30082,877693765,2022-10-31
42ec0f8d4a9f4523,t-mobile,293583592,9677647,1859085,303628,305423952,2022-10-31
0ab05cd8804b8086,,4465396,526307,0,0,4991703,2022-10-31
9f85954baabb84dc,,906030,311238,0,0,1217268,2022-10-31
cf9e6d6601e90f6d,t-mobile,625908922,29962183,88722,955355,656915182,2022-10-31
16781bd5624ad239,t-mobile,4885191,701936,6708,2020,5595855,2022-10-31
577acb486fe3a80d,verizon ,29491419963,558740118,1834852,241808,30052236741,2022-10-31
907d7d533e7c2480,verizon ,7475575257,182432142,1080588,177325,7659265312,2022-10-31
ba3ea422389ffb88,mint,338072,115904,333268,590508,1377752,2022-10-31
66ecbfc2568cabd1,at&t,0,0,0,0,0,2022-10-31
7d3e09f84a24f84d,at&t,868521,226035,0,0,1094556,2022-10-31
f0cd204a6779e382,at&t,15041108108,344318244,112863915,2154454,15500444721,2022-10-31
a0b812aa2c93a4ae,t-mobile,0,0,0,0,0,2022-10-31
ae093d4f44407da4,,815003,262169,87366,28391,1192929,2022-10-31
16eba986e937ad1c,mint,625469081,47358708,551482,54966,673434237,2022-10-31
43a11979bd14dc76,metro by t-mobile,839857730,74985327,0,0,914843057,2022-10-31
b0b09c101c7003c4,t-mobile,548027679,24338606,1535618,216698,574118601,2022-10-31
b9d08d71ac455125,t-mobile,606951418,36739229,973827,152820,644817294,2022-10-31
0632d47e76f454fa,t-mobile,1393587618,15677621,0,0,1409265239,2022-10-31
b3cd541805a68e98,verizon ,596810,180535,722720,263319,1763384,2022-10-31
40bf5ad08887a922,mint,408750,148426,0,0,557176,2022-10-31
1686f48bbe9e03f2,verizon ,732027,194890,183801,73488,1184206,2022-10-31
fb771add48bb823b,t-mobile,649521184,18873801,104,293,668395382,2022-10-31
ea5dbc33c9d2f7a2,verizon ,425595693,6354817,158483,62407,432171400,2022-10-31
3d693a22b1036768,verizon ,3587954257,189069306,63588,24348,3777111499,2022-10-31
ae1eb6dc9c6dc7da,,84,84,210501,87502,298171,2022-10-31
775597788d05921a,t-mobile,54311901,1206654,0,0,55518555,2022-10-31
d32ce7af9f35344a,t-mobile,120112768,4177427,8241,56888,124355324,2022-10-31
e6d5f929d271bfff,t-mobile,0,0,0,0,0,2022-10-31
0d36b793dec9b210,t-mobile,15984587609,277792265,1564886,277562,16264222322,2022-10-31
057ae1c061a2ed3b,t-mobile,0,0,0,0,0,2022-10-31
8a38b046742186eb,t-mobile,0,0,0,0,0,2022-10-31
382b2757f840852a,at&t,0,0,0,0,0,2022-10-31
573d125f1592f67d,jio 4g,136971,299653,376,290,437290,2022-10-31
8c0832bbf5477d9c,verizon,0,0,0,0,0,2022-10-31
ae6e7fa754f55309,verizon ,0,0,888959,346472,1235431,2022-10-31
1ca1da7faa1cf60d,verizon ,0,0,0,0,0,2022-10-31
ac41191526687d19,verizon ,406967202,8155156,100758766,2909796,518790920,2022-10-31
27a8121cc13416fe,t-mobile,619312534,50459783,248910,36627,670057854,2022-10-31
5e3575cf7d6dcade,t-mobile,560058265,55552887,1019571,95671,616726394,2022-10-31
a2c69d0590d5a680,,305318,92591,58788,9570,466267,2022-10-31
eeb600b74f234faa,,708456294,10653195,664,10128,719120281,2022-10-31
76b6432c588b3483,t-mobile,996867,278923,0,0,1275790,2022-10-31
ee5e3d440cda3476,at&t,0,0,85975,34291,120266,2022-10-31
f49f640cbe0be0f1,t-mobile,589774,184082,94652,37160,905668,2022-10-31
5d288d3da55240c3,t-mobile,8948174729,214499026,925269,165435,9163764459,2022-10-31
7f52e981de1593ec,verizon wireless,810674,238721,533,259,1050187,2022-10-31
0249257afa944717,,13183320,1308767,0,0,14492087,2022-10-31
16eefdc6c02b3934,t-mobile,904479550,103700765,14019,4602,1008198936,2022-10-31
4792b30c60cc52bd,,262775,76854,0,0,339629,2022-10-31
641f852ffb12a1e7,,334093371,6168100,0,0,340261471,2022-10-31
7dfc2bf184ff7261,,4398752,251986,0,0,4650738,2022-10-31
35a8be109364146c,,596995,165391,236539,66463,1065388,2022-10-31
85efc10ada0ca75a,t-mobile,0,0,0,0,0,2022-10-31
55205a286c664f5e,,286069,945827,0,0,1231896,2022-10-31
d2b1ca0d0faed158,t-mobile,346885978,6006035,3963911,269149,357125073,2022-10-31
f9fb310d6334c620,mint,0,0,0,0,0,2022-10-31
b261e8c1fc31c026,t-mobile,246655490,5638075,177841,79636,252551042,2022-10-31
8c7f44ed2ac2b40f,t-mobile,4850,1438,17386,333464,357138,2022-10-31
7bcec33371115c01,,14358,2249,0,0,16607,2022-10-31
9f48baa052a401ab,,157988301,3184482,0,0,161172783,2022-10-31
97ba91eebcb83bec,t-mobile,0,0,0,0,0,2022-10-31
0105531b9caf6b5b,t-mobile,0,0,0,0,0,2022-10-31
32e9eed31e2ce8af,,87844500,5883553,0,0,93728053,2022-10-31
ed5ad3dd58052084,Verizon ,0,0,760484,77532,838016,2022-10-31
79031dcbd1546adc,mint,19312,138193,12527,4271,174303,2022-10-31
922434905b5d76b0,,46646952,898842,0,0,47545794,2022-10-31
bb80adc7d3f69d1c,t-mobile,0,0,0,0,0,2022-10-31
2072d520d5daca0f,t-mobile,1907006576,120035329,469087,173354,2027684346,2022-10-31
9943b66047ad16e0,verizon wireless,0,0,0,0,0,2022-10-31
c79ef07ce1c4271d,,727946066,33867392,0,0,761813458,2022-10-31
aa5046055772fb2d,,537375242,10005752,0,0,547380994,2022-10-31
7083dbd0b6329f94,t-mobile,580597904,27237156,14955,5134,607855149,2022-10-31
4bb6e1e195b1ddf1,Verizon,0,0,0,0,0,2022-10-31
a7fc457b3bdde10b,t-mobile,0,0,0,0,0,2022-10-31
9f04ed3908ac4a05,t-mobile,806191,279019,955468,329354,2370032,2022-10-31
b2905113034c3c03,verizon ,102575467,1575278,491917,145414,104788076,2022-10-31
d6019ca9fe0498c9,cc network,0,0,0,0,0,2022-10-31
e993d9a55d0ed2a4,t-mobile,1075999005,20249170,5169,1840,1096255184,2022-10-31
3ee6e7da32f7f0ba,t-mobile,53406,30035,235389,74548,393378,2022-10-31
8ae80c5fb720acd6,at&t,0,0,0,0,0,2022-10-31
bb274fc758f5ec84,,823888,291650,0,0,1115538,2022-10-31
0c12f12679b81c75,,383491446,6112614,0,0,389604060,2022-10-31
346ba3e4fafd42f1,t-mobile,0,0,0,0,0,2022-10-31
cffd44c9fae049f0,,6417945624,119203516,0,0,6537149140,2022-10-31
45385b78cd6e6598,,1141890577,66186692,0,15593,1208092862,2022-10-31
cff4ee9f74635839,,773362444,13315983,0,0,786678427,2022-10-31
0c674fe0423d1ba5,,2279501576,37211128,0,0,2316712704,2022-10-31
f2d8386eadb65360,verizon ,0,0,234148,76488,310636,2022-10-31
532ff64d966e3a34,t-mobile,251497358,15866758,387,6024,267370527,2022-10-31
625b97abe2cfc5b1,,445814667,36049903,36073,11543,481912186,2022-10-31
abf005ef005c426b,,119172019,2385910,6964,2597,121567490,2022-10-31
6855c1d40ec079a7,t-mobile,195303463,8723017,104,104,204026688,2022-10-31
33256ae3c665d338,verizon ,1243446406,40517268,1203,16228,1283981105,2022-10-31
b7c4b7d19e17222a,t-mobile,801973871,58595832,64,177,860569944,2022-10-31
ac96314fedbcd36a,t-mobile,0,0,1088367,411997,1500364,2022-10-31
faa26ac01bb6e998,t-mobile,679526265,59674326,1052080,192180,740444851,2022-10-31
ab097c8e612bc653,mint,3436481816,115950595,6364,1795,3552440570,2022-10-31
d5ef5f7fb174509a,mint,156355932,2348315,157711,2140428,161002386,2022-10-31
636cf6bc758ec14a,,14406,5635,485485,167761,673287,2022-10-31
14ee32ea16e21c3e,at&t,923163,269376,847487,399624,2439650,2022-10-31
38a94d01944977b1,at&t,555954,141894,369447,88083,1155378,2022-10-31
4fd903e549bd132c,mint,938585,120096,6863,2101,1067645,2022-10-31
0a5ddd40b671f45f,t-mobile,1334790739,71372960,121059,51039,1406335797,2022-10-31
c74f75e5008724bd,t-mobile,337623837,4862934,61560,616847,343165178,2022-10-31
65def10f81dbd7f6,,816748751,85067992,1480092,218139,903514974,2022-10-31
fa52ac4e27cff003,,5644818814,130491814,27995,9181,5775347804,2022-10-31
8b3e76bf76fbd546,t-mobile,0,0,0,0,0,2022-10-31
6308a990b033f452,t-mobile,77841620,1295241,15311,4311,79156483,2022-10-31
14b5de94868a726b,t-mobile,673773,187524,0,0,861297,2022-10-31
d742b308c9d25e72,,39615669,1081876,949713,290486,41937744,2022-10-31
923b49cc3f1e2b34,,626894182,7817478,0,0,634711660,2022-10-31
2af48d98fd2ebe7b,,780489,248224,438352,150371,1617436,2022-10-31
9f7632b9177da2c0,mint,55295544,1011221,49447,23704,56379916,2022-10-31
b83f1e9f171e6709,t-mobile,649043,222243,23576,6221,901083,2022-10-31
7e5ad50bd6bb16f3,at&t,1133052,542573,18739,13278,1707642,2022-10-31
999e650f52c97ec3,hello mobile,247760406,4611169,0,0,252371575,2022-10-31
5e4055c03df98727,at&t,82382747,1532831,0,0,83915578,2022-10-31
16bfbeec579ff5c2,verizon ,0,0,0,0,0,2022-10-31
154d34665eeb0644,verizon ,859365928,75781359,132789,43589,935323665,2022-10-31
b9c52331312d1b88,t-mobile,0,0,0,0,0,2022-10-31
9a94b29b5e5184b9,t-mobile,23727715,666536,0,0,24394251,2022-10-31
03c5355df085e394,,132015,35938,0,384,168337,2022-10-31
617c53f363ef590b,verizon ,170108,50998,15122,3889,240117,2022-10-31
7b3c05b90801dc42,,782119524,76295313,0,0,858414837,2022-10-31
b923ecf4b6759a07,t-mobile,18661298,519872,929653,326329,20437152,2022-10-31
2aed050dd3b77b42,,16867078,564533,0,0,17431611,2022-10-31
f1cd43d4f64e68fc,mint,1157700,224887,547239,68445,1998271,2022-10-31
d355136514768d45,verizon ,0,0,860569,230505,1091074,2022-10-31
fe66ae8189fbdf35,,741704,188067,651068,187328,1768167,2022-10-31
4d657fba5441912e,,103602721,678179,104,104,104281108,2022-10-31
cd2bdc4a31ebb787,,20157,10697,0,0,30854,2022-10-31
916f230427f57c7b,mint,38335,14136,603880,327305,983656,2022-10-31
a212589898979bf4,verizon ,0,0,922887,388835,1311722,2022-10-31
ff28600ce199d363,,698418562,45979718,318589,111512,744828381,2022-10-31
29d27ebde6b251ce,,881613810,11648097,277372,110438,893649717,2022-10-31
43ffd8c96a8e3ab3,airtel,0,0,0,0,0,2022-10-31
9a33b8d6eff5d6b6,verizon ,278638752,16682493,13515,4008,295338768,2022-10-31
57e4300168946bbd,t-mobile,422518735,6729633,515864,210109,429974341,2022-10-31
7b66934e659787f1,mint,391072162,18792407,2813347,80847,412758763,2022-10-31
fa6ea8d1629fa2f6,,806137,228098,126051,46606,1206892,2022-10-31
e3569a5ae99600fa,,70188992,1489685,0,0,71678677,2022-10-31
db1aeff74aac28d8,mint,845094,252412,198749,79537,1375792,2022-10-31
87bb1a655a9f9785,verizon ,690022840,52716841,21380,5381,742766442,2022-10-31
126a3f284c07ac7d,mint,1794215835,52638631,37925,9643,1846902034,2022-10-31
bb2d8e074d97e17a,mint,1848043322,59394967,637395,53328,1908129012,2022-10-31
db3869287c4df135,mint,416696977,56453448,1287099,72132,474509656,2022-10-31
c97e2737b1b75d6d,verizon ,1023829043,25815390,1012,10918,1049656363,2022-10-31
7502f474669a812d,,19762692,680668,0,0,20443360,2022-10-31
0c81ea98b6c8b37f,metro by t-mobile,520059,156686,287262,84315,1048322,2022-10-31
64eabe0219137019,verizon ,566948106,50284749,118716,39150,617390721,2022-10-31
5cc605ed53b1bce8,,250447569,3934914,0,0,254382483,2022-10-31
518fe3f11d801605,mint,113929931,7830102,194304,71369,122025706,2022-10-31
6ee5e626ec1b7718,at&t,77549711,1471699,268722,90075,79380207,2022-10-31
d0179af1938117ca,,3364033640,114828655,24713,9493,3478896501,2022-10-31
ab1f63d7c6128779,,39767355,1024503,0,0,40791858,2022-10-31
4b4f95c11d7c89bc,,53041751,663753,0,0,53705504,2022-10-31
1fd3dd898d4ab2aa,t-mobile,584176,184855,14950,3806,787787,2022-10-31
79ec3d73676c75d6,t-mobile,49660015,749050,0,0,50409065,2022-10-31
9020507024a54b8c,t-mobile,750419543,27688603,37321690,2102547,817532383,2022-10-31
a1e5474cac10d8f3,t-mobile,483731666,54509888,1843035,275331,540359920,2022-10-31
52e922c90a77f812,,16152,4784,0,0,20936,2022-10-31
c43b96d552025a03,mint,736167884,45923451,924037,237334,783252706,2022-10-31
8d435a781899c364,t-mobile,690932,215603,100015,34401,1040951,2022-10-31
e221cf41176fd81c,,84,84,16539,120696,137403,2022-10-31
01675b4c7812cf99,home,119232261,1571724,0,0,120803985,2022-10-31
e1bbc7be4463ff3e,mint,800645469,49607703,1587354,262494,852103020,2022-10-31
090728a1e7ef8345,mint,325959470,24216902,0,0,350176372,2022-10-31
7f4f21a524f5fcbc,t-mobile,849345,239438,107909,38594,1235286,2022-10-31
cc4cb4280bb1fe14,cc network,694859,239229,0,0,934088,2022-10-31
1a67117b779d13ca,,208426833,6813185,0,0,215240018,2022-10-31
90c4fa699fac2e14,at&t,22298,7188,805470,229498,1064454,2022-10-31
cce2a36d93152f04,t-mobile,1654078557,153954165,836,760,1808034318,2022-10-31
fb67ce4f75207ae5,verizon ,706466131,43788864,21716,8682,750285393,2022-10-31
13c9fe883b903fd9,,16422444,590135,0,0,17012579,2022-10-31
a7b9910ede88bc89,t-mobile,4380571489,113911124,6972,2284,4494491869,2022-10-31
6b442dea65c90993,,126867,151735,129699,51601,459902,2022-10-31
b05836dee2281899,mint,30687528894,436864820,748880,69430,31125212024,2022-10-31
8d0fdec50416ed77,,688191,197930,0,0,886121,2022-10-31
752eab573eb25e84,t-mobile,668513926,65873622,2741,19722,734410011,2022-10-31
3cbcaff053107e51,mint,348275968,28226837,682394,59976,377245175,2022-10-31
19cc3dcd1ccc2251,,358066,126437,15655,4104,504262,2022-10-31
fe9686c682ac4e4a,,53719525,940236,0,0,54659761,2022-10-31
cac1c4598deb74d5,t-mobile,0,0,906565,298493,1205058,2022-10-31
f2467e8a8ae2e134,mint,108648622,1786559,53850,30202,110519233,2022-10-31
336fb814739d29f1,,14553,4439,0,0,18992,2022-10-31
54c583645ac888fe,cc network,706773423,14150210,55652,25056,721004341,2022-10-31
a2e0c0652f88012c,gsma,59618022,2745741,24969,56944,62445676,2022-10-31
08b70f7fc5a9500b,t-mobile,135969808,2714406,0,0,138684214,2022-10-31
4a56c0fda378829e,mint,1120561905,37008108,217708,74405,1157862126,2022-10-31
c40ec1580d9fef25,,228268927,16232129,1560802,407557,246469415,2022-10-31
8cf818174e80247e,t-mobile,194725883,14052194,104,104,208778285,2022-10-31
67105c8ad634be26,,28591,8072,39518,12226,88407,2022-10-31
450dc1f2ec090aa6,,603557217,10341676,0,0,613898893,2022-10-31
5c7ac23427de6781,at&t,1510317,261590,153461,51505,1976873,2022-10-31
66bfe913ef2b9023,t-mobile,541135689,62689981,102459,40144,603968273,2022-10-31
c3033d54ebe9a686,t-mobile,0,0,133811968,4923184,138735152,2022-10-31
70d8dd023810c90b,,64791655,1638379,0,0,66430034,2022-10-31
30c5248ccc60637e,mint,599533600,26587923,551049,169392,626841964,2022-10-31
8fd975d371ff2834,t-mobile,833033,242668,15850,4834,1096385,2022-10-31
6e01d6c1514bd8b0,t-mobile,506069375,7650278,0,0,513719653,2022-10-31
30d2cd4d62aa5ec9,mint,243330,70705,2406,29874,346315,2022-10-31
d156449984887b82,,782264,208959,0,0,991223,2022-10-31
4df9fa3bcfbac34d,mint,1272569994,58745639,30174,20317,1331366124,2022-10-31
c9fb8658ef44f707,,90979,225646,0,0,316625,2022-10-31
72b72b3c1ca75691,mint,130558036,2901019,13949,2435,133475439,2022-10-31
a399563eb253843c,,62030201,987666,0,0,63017867,2022-10-31
ce4973d5ae3c1970,mint,681860,175255,337053,103383,1297551,2022-10-31
9d6fb30e7c7670ca,mint,488795,627964,0,0,1116759,2022-10-31
decbcc569a7f2ffe,mint,694524257,18098632,21125897,789616,734538402,2022-10-31
45bc689129a913b7,t-mobile,36398795,999296,51787811,1410431,90596333,2022-10-31
d2b314d23e869996,mint,1572874607,79585592,6855,2479,1652469533,2022-10-31
1a5673302f4a1885,,48261,27653,0,85,75999,2022-10-31
693d464035849f9e,mint,829625703,78637684,936455,156692,909356534,2022-10-31
94240f9e77c31069,,1194434110,85245548,3239232,394482,1283313372,2022-10-31
91d2489b162f5e4d,verizon ,0,0,44400600,1157575,45558175,2022-10-31
75cb8ea2224d2bac,,148301398,2583418,0,0,150884816,2022-10-31
9f25ac43eab40a1e,,285575391,26924778,738165,184967,313423301,2022-10-31
844934ee924a172c,mint,736461,209507,552488,170558,1669014,2022-10-31
c15e9157f2701791,,87999,121318,0,0,209317,2022-10-31
8c9dd24bead0d984,mint,1236025649,56266138,1324994,105564,1293722345,2022-10-31
2191a8a463f651fa,mint,1061229736,72247696,21627,6542,1133505601,2022-10-31
34c642508dae7bb7,mint,1410485494,54653419,1185484,235183,1466559580,2022-10-31
0cb2d71909dce1b6,mint,779085962,48786429,1076548,221591,829170530,2022-10-31
925037fed20745d6,mint,288276944,21436575,899020,138679,310751218,2022-10-31
6bfb50e6574d7c5b,,24076154,1028655,0,0,25104809,2022-10-31
f87b36dedfa66796,,35282,7393,0,0,42675,2022-10-31
acaf20733fc65cf5,mint,801308231,46343217,347839,31431,848030718,2022-10-31
5b2e48c6cf40d572,mint,938324879,24027209,1156298,210665,963719051,2022-10-31
04e18a40a7e15215,verizon ,0,0,0,0,0,2022-10-31
43c8d3cfa80a4610,t-mobile,621535613,46956123,5443,1854,668499033,2022-10-31
7a8b9135d4335c05,,140990580,8361180,0,0,149351760,2022-10-31
3f4489a3893456a0,t-mobile,672223867,69292221,1193543,227577,742937208,2022-10-31
27d3e317b8372d8b,t-mobile,0,0,0,0,0,2022-10-31
6abed3bfe9c6e728,,7803074556,139795261,0,0,7942869817,2022-10-31
39e0802c7228064a,verizon ,25722585401,486168192,1779791,483840,26211017224,2022-10-31
f2696160e1f4eb12,verizon ,558709175,55962785,700428,60166,615432554,2022-10-31
1eb10cb2561d66a8,verizon ,2072117430,45559251,28160,8021,2117712862,2022-10-31
b23f5316a61dcc91,,667220,174567,17448,5228,864463,2022-10-31
24a01c953a19a20d,,82933040,1686475,0,0,84619515,2022-10-31
8ac2389e1f52a8d4,,879098,254485,0,0,1133583,2022-10-31
944aa0f8c1fb5255,,30001,129973,635127,207467,1002568,2022-10-31
33ff0d666a03d082,,953200,269127,332931,104385,1659643,2022-10-31
7900046561463745,t-mobile,0,0,0,0,0,2022-10-31
3a2756243d6b5098,t-mobile,0,0,0,0,0,2022-10-31
b84328b2d83e9c98,t-mobile,1160128,449152,377564,171341,2158185,2022-10-31
288f5c243d626f32,t-mobile,681364378,12651367,3045,54438,694073228,2022-10-31
13db8dbe5cf97507,t-mobile,9004748572,202994928,699130,42367,9208484997,2022-10-31
d57fe5a326bf9422,t-mobile,2712583464,50584916,1003779,219100,2764391259,2022-10-31
6ab035135b1f6199,t-mobile,936788,283483,550,8279,1229100,2022-10-31
61afc18e79f8bb6e,t-mobile,0,0,664766,264383,929149,2022-10-31
5ff2a499e2322b6a,cricket,0,0,44966866,1026594,45993460,2022-10-31
adb1f8de2c134df1,t-mobile,0,0,0,0,0,2022-10-31
ce58c01bfa235630,t-mobile,0,0,0,0,0,2022-10-31
e7c148d59ae3ae5b,t-mobile,35758790,708718,79228469,2823522,118519499,2022-10-31
9df3e493bb13c996,t-mobile,0,0,0,0,0,2022-10-31
ad045e091f824e16,t-mobile,749232,229438,796024,279292,2053986,2022-10-31
cdf143b16e61e5eb,,1479581024,25153167,0,0,1504734191,2022-10-31
5c062c05500f1177,,151922497,4487402,0,0,156409899,2022-10-31
b4284693e6ec13c0,,13198192703,229245625,0,0,13427438328,2022-10-31
97d54551d436a883,,1354046317,27944110,0,0,1381990427,2022-10-31
529c5c09e33b14dc,t-mobile,806276,367312,20772,166354,1360714,2022-10-31
25be17f55498f531,t-mobile,1518010701,71459556,1220327,246865,1590937449,2022-10-31
9335d032bfb7fccf,,214070342,1782457,0,0,215852799,2022-10-31
ae841d4db1a31bbd,t-mobile,4221446443,111965099,1047693,193515,4334652750,2022-10-31
6d48d0413ec408db,t-mobile,0,0,0,0,0,2022-10-31
c68d9deaa356a8da,,835711,247902,99095,29253,1211961,2022-10-31
378cbf8413d9456a,t-mobile,202107127,4514167,163375,56986,206841655,2022-10-31
efc41016545ff1fd,t-mobile,469846741,55833655,427978,152292,526260666,2022-10-31
06b906fc1db0607a,,447127,121333,0,0,568460,2022-10-31
54ee02d386ff1d24,verizon ,19621487007,351183508,1130406,84333,19973885254,2022-10-31
7c64b203ee1214b2,verizon ,32763,25720,721744,340606,1120833,2022-10-31
308bb77fd46ac6ec,at&t,0,0,831726,247054,1078780,2022-10-31
ca0cad5f05300ee1,,729887340,4485093,0,0,734372433,2022-10-31
117f8356afc10f39,verizon wireless,0,0,0,0,0,2022-10-31
a7c828368cf8d613,,781075,215166,14952,125734,1136927,2022-10-31
cfe740bccc43282c,at&t,0,0,0,0,0,2022-10-31
77d17c0430c45652,,17727959,2800817,0,0,20528776,2022-10-31
e6f6414dc3ebca0c,,38765576,1030452,0,0,39796028,2022-10-31
ca97f644264a7840,,24017734770,395953725,0,0,24413688495,2022-10-31
c6652343e6491567,,78036820,1893903,0,0,79930723,2022-10-31
6c1d403054ce46ad,,1785471,431815,0,0,2217286,2022-10-31
9c802ba0da34b835,t-mobile,416366253,67409956,59032,48792,483884033,2022-10-31
1e9a793f9d1c042a,t-mobile,786411153,51778147,7044,2428,838198772,2022-10-31
ff54869253be30a3,,38815427,1726486,257682,76012,40875607,2022-10-31
2f53a6df6c2be017,,2661717093,47104078,0,0,2708821171,2022-10-31
ecd2ab6f09c7abac,,66654857,2119509,0,0,68774366,2022-10-31
e53c276591ceef0b,t-mobile,881882,297867,339536,134288,1653573,2022-10-31
cf3abcdc75d513bb,t-mobile,831862,292598,30642,10357,1165459,2022-10-31
aa0efbfb2866b8f0,verizon ,13736779,444115,13995122,490575,28666591,2022-10-31
0fc37ae3ba41d760,mint,0,0,0,0,0,2022-10-31
cfdb8d8c5e8e08ae,verizon wireless,230102927,5873549,3645048,328283,239949807,2022-10-31
850e00f6699d0797,,456841876,13053316,0,0,469895192,2022-10-31
1e19fb2b9d3a7c09,t-mobile,446385290,42679792,0,0,489065082,2022-10-31
b5a17af9767f56c6,,20053,7009,0,0,27062,2022-10-31
753202113d872713,verizon ,772730026,66986293,726461,52682,840495462,2022-10-31
84b6ab18d3d672f6,t-mobile,755684,261797,88619,31911,1138011,2022-10-31
6c1aca49c005106c,t-mobile,812548,314808,7212,2066,1136634,2022-10-31
3cf6f141ea2c0b8a,t-mobile,604309767,53515672,835666,105855,658766960,2022-10-31
225eaa6aa0dd2eae,mint,241914457,24812915,36482,13700,266777554,2022-10-31
4f53e531a3cb4570,t-mobile,0,0,18274,104065,122339,2022-10-31
f60c113f39e484fe,,626454609,50992171,641796,429945,678518521,2022-10-31
eecad304b8fbc72e,at&t,0,0,43827,11269,55096,2022-10-31
eb22cf467b9d5be2,mint,666403979,60959330,611645,27030,728001984,2022-10-31
8e92b2fba934af2b,,752788,256335,0,0,1009123,2022-10-31
90cc3e5ae14d8a62,t-mobile,817291,240597,473935,125834,1657657,2022-10-31
bfacb903ac8ba329,verizon ,154253318,23746355,2008976,308537,180317186,2022-10-31
ac22a0fc3d9080b7,verizon ,3045399938,112195047,104532,36817,3157736334,2022-10-31
c106d864325da489,t-mobile,108579627,1850944,0,0,110430571,2022-10-31
c80a9e09f898039a,mint,3062389668,87616495,749164,67810,3150823137,2022-10-31
0db3c0f6e72dc70e,t-mobile,735642,217168,7785,2199,962794,2022-10-31
7ea7a024f2cc9d5e,t-mobile,9681948704,216469868,68092,24586,9898511250,2022-10-31
eb8c8faab311af0d,mint,29321337,2259055,141,1074,31581607,2022-10-31
80b6e8c2216cc2ff,t-mobile,508837965,47453958,0,1131,556293054,2022-10-31
ad9b7c3e0b4e346d,t-mobile,28414828,6030950,0,0,34445778,2022-10-31
d5109ff299c71c49,mint,49890149,2264812,6493,1679,52163133,2022-10-31
4fdadf523a1ebd86,at&t,134326,39415,133399815,2371982,135945538,2022-10-31
c8f26c9b16fa2bfe,at&t,925633,327190,610358,210386,2073567,2022-10-31
7af2a642e435e268,verizon,848385,241477,0,0,1089862,2022-10-31
541898933a28f72a,verizon ,681782024,70861078,1163469,239237,754045808,2022-10-31
e6c9110213bcbdad,verizon ,1065080481,17325509,38979,27917,1082472886,2022-10-31
7e23e67d05087018,verizon ,604431636,38698338,898753,1005739,645034466,2022-10-31
515b17ffbc117433,mint,808808183,11632585,0,0,820440768,2022-10-31
77101ca04ae1e17d,verizon ,16335736787,279785518,9637,3178,16615535120,2022-10-31
c0e68ceba8d267b3,verizon ,19202001062,333591440,672,894,19535594068,2022-10-31
ea82741d3bed9e73,mint,678942130,74373402,588400,11702,753915634,2022-10-31
d802daa9951c2ccf,t-mobile,961835,365456,458886,200937,1987114,2022-10-31
c89f108d34eb8400,t-mobile,888621,281073,0,0,1169694,2022-10-31
864272359359bcef,t-mobile,0,0,0,0,0,2022-10-31
d795f8232f6d6c16,verizon ,295297338,36262933,1210462,29792,332800525,2022-10-31
ab6ee490b1b14a86,t-mobile,0,0,0,0,0,2022-10-31
b80047f2da17e6e4,verizon ,0,0,0,0,0,2022-10-31
a123dddde47788b0,Verizon,0,0,0,0,0,2022-10-31
b373fac18a8ee2bd,t-mobile,0,0,114080017,2269109,116349126,2022-10-31
940efbaa7a36e6bc,verizon ,0,0,234079177,4103721,238182898,2022-10-31
61e3cb5519e7cd6f,verizon ,4859474407,134858582,169922,66021,4994568932,2022-10-31
ff34b87ca9646631,verizon ,4348156454,85285241,2035072,325669,4435802436,2022-10-31
db070bc8e7d68a98,,34562,134107,0,0,168669,2022-10-31
21448d2059aca404,mint,186586411,16493823,1845159,267785,205193178,2022-10-31
5e9c8d65b750ab4b,red pocket,0,0,854174,268012,1122186,2022-10-31
37a0a94a98ab8dd9,good2go mobile,0,0,0,0,0,2022-10-31
86b67a0fe4a0343e,,1202278701,62889012,0,0,1265167713,2022-10-31
d17cddaee10d8f28,t-mobile,9324851051,218877693,1790762,257162,9545776668,2022-10-31
a22a0f213e2ad921,,926428,319312,49295,1076417,2371452,2022-10-31
e85f704cddec6586,,2884981840,63273347,0,0,2948255187,2022-10-31
faaf836df4a4469c,t-mobile,5932835355,142185320,196075,71459,6075288209,2022-10-31
d89150c551b7f532,t-mobile,812470,248558,172957,51162,1285147,2022-10-31
ef98b536f8fda132,mint,0,0,0,0,0,2022-10-31
4f666dc96dd1c599,,322548604,7814175,0,0,330362779,2022-10-31
6483ad8f3bc00dba,t-mobile,37700,194036,0,0,231736,2022-10-31
8b75853b9c3f7307,t-mobile,662611,209872,82523,27524,982530,2022-10-31
78aa8953cc738556,,367687020,6732209,0,0,374419229,2022-10-31
5e1aa2b9d2334bdd,,177384103,3291801,99942,42760,180818606,2022-10-31
3a7046bf648fcb8a,,241977,685256,509245,187171,1623649,2022-10-31
463bf73ded22e558,t-mobile,0,0,0,0,0,2022-10-31
e0afcd4854e62b37,t-mobile,0,0,0,0,0,2022-10-31
854ab740b1664e31,t-mobile,0,0,779349,254969,1034318,2022-10-31
4b13614a90324c11,t-mobile,505128664,31123395,1062743,181433,537496235,2022-10-31
241984d577fc08c0,t-mobile,485599246,46307482,1378554,293976,533579258,2022-10-31
132f57acaa1d1453,mint,980240603,75494205,1037138,190907,1056962853,2022-10-31
1b334fa1c694267d,t-mobile,0,0,0,0,0,2022-10-31
b294e715b8d990c4,,820296,352676,29752,9125,1211849,2022-10-31
9c3d90129bbab7de,,321304020,12922836,0,0,334226856,2022-10-31
4fddd3b13990e847,t-mobile,106232,62951,362306,2503472,3034961,2022-10-31
fdb16adeab8a1dcf,t-mobile,0,0,0,0,0,2022-10-31
be0f8d34e8912cfc,at&t,555907,166640,0,0,722547,2022-10-31
785d0e0503b66dac,,1399734707,62393908,0,0,1462128615,2022-10-31
57027ad2bdf61f5b,t-mobile,718057840,46783245,722418,76405,765639908,2022-10-31
377b028658b1762f,verizon ,448684577,25177168,0,0,473861745,2022-10-31
641b371b75bdb45e,verizon ,12734246393,283051026,4382903,926192,13022606514,2022-10-31
6a4ee3d615fcecbc,t-mobile,328916321,8590253,0,0,337506574,2022-10-31
ab3f2c38cf37447a,,207407940,2216217,0,0,209624157,2022-10-31
ffbc1b2f4657c9ff,verizon,0,0,0,0,0,2022-10-31
83b35d31d2ce064b,,62781,8911,66984281,2181112,69237085,2022-10-31
f624b3ebd39e0904,,483915,177719,0,0,661634,2022-10-31
5235bd70afa8458e,t-mobile,193141,67877,17706,5172,283896,2022-10-31
084dc7956081f422,ting,0,0,0,0,0,2022-10-31
c924766639e88aa2,t-mobile,1555212735,52404881,802926,110675,1608531217,2022-10-31
80298bc5d526d3a3,t-mobile,3572973172,94144443,13022,3697,3667134334,2022-10-31
cc1901fefdf323dd,t-mobile,575863400,24330895,0,0,600194295,2022-10-31
846c7a2a6dd31e5d,t-mobile,0,0,16611,7859,24470,2022-10-31
6815f993a940ca20,,2092918614,78484963,1759566,240074,2173403217,2022-10-31
e27b590c70bee09c,t-mobile,636608329,44413406,0,3281,681025016,2022-10-31
dcef1d9b2effce67,,2567306541,46316936,0,0,2613623477,2022-10-31
e736989ce2635516,t-mobile,942635514,75251796,17521,7029,1017911860,2022-10-31
c6f4abc20d07fdae,verizon ,123691751,2506817,15319,5367,126219254,2022-10-31
c273d092f1439ddd,,4421943656,135491545,25327,216104,4557676632,2022-10-31
9685000b0d3f8000,t-mobile,0,0,0,0,0,2022-10-31
ba0bb9601acb246b,verizon ,10327248064,220154701,1243007,233801,10548879573,2022-10-31
76c500103b9722f3,mint,831106,252310,333074,116595,1533085,2022-10-31
522a20c1fd7b882f,,10998,31664,91852,16316,150830,2022-10-31
e2c8b4603716a5d9,home,1094318,428591,448239,236029,2207177,2022-10-31
c00a7184c00aefe4,t-mobile,1135919237,69057843,216832,79945,1205273857,2022-10-31
9cc589067da44be8,verizon ,319612699,8514433,678755,52816,328858703,2022-10-31
b5eb5bba6175646e,mint,1014850734,62091410,9612,7326,1076959082,2022-10-31
c2082c70ca625af2,t-mobile,36173,8327,578,1865,46943,2022-10-31
e34603ba2a440ac0,t-mobile,0,0,0,0,0,2022-10-31
23676302a5660693,home,1040981,129494,0,0,1170475,2022-10-31
ddcbf38844306304,verizon ,255648392,29927958,6661,1793,285584804,2022-10-31
2a42fa69c806eb9e,,1032533242,17774315,0,0,1050307557,2022-10-31
faba3271ad694d6d,,171302084,18466546,0,0,189768630,2022-10-31
01532977600af740,,45336,9542,0,0,54878,2022-10-31
4d40f0dbb4ab401d,t-mobile,986754953,81128180,17429,6581,1067907143,2022-10-31
b18ce6806c79cdb9,t-mobile,0,0,0,0,0,2022-10-31
00415fd6bfe33e04,verizon ,460831115,6827768,1341113,116691,469116687,2022-10-31
1e303d76ebdd1ff1,verizon ,0,0,0,0,0,2022-10-31
efcffa5ff81a5441,t-mobile,770333309,57188453,2364414,582685,830468861,2022-10-31
9554eba10a8e04e0,t-mobile,729441,309931,215150,89345,1343867,2022-10-31
c7cabdeb5c279421,at&t,1539364,275188,0,0,1814552,2022-10-31
d30c7ab92b2de458,at&t,0,0,0,0,0,2022-10-31
0430bd3d2649d212,t-mobile,0,0,0,0,0,2022-10-31
af5eebe4440bf789,mint,21488,8275,0,0,29763,2022-10-31
8aa13634ae7a2e87,t-mobile,37878,123190,214695,81668,457431,2022-10-31
98b02087c569a057,,674871167,8287631,0,0,683158798,2022-10-31
a6d649d1d9c3f636,at&t,73189,30591,0,0,103780,2022-10-31
a97f38e948db6a57,mint,744058601,37962317,1235792,769603,784026313,2022-10-31
9f851d189e8cf891,,822108,242454,314439,100149,1479150,2022-10-31
7d78e9afcb912e2a,,22481596,909211,998700,354002,24743509,2022-10-31
cc79e14b4aceaabf,verizon ,45347985,6392233,0,0,51740218,2022-10-31
1dab47a84dfbd713,,142740190,2833597,0,0,145573787,2022-10-31
c4a6afcadbac699a,mint,578040463,11853040,4165383,443385,594502271,2022-10-31
92939e3dd6c47703,verizon ,562898122,13491560,0,0,576389682,2022-10-31
abbd5882798962de,verizon ,3619807,802100,879397,204084,5505388,2022-10-31
005e194f9c10fc33,mint,748471,279997,45488,15002,1088958,2022-10-31
0e29b2c10b4184d5,mint,41885,9137,0,0,51022,2022-10-31
b86a1f5016e6c45f,mint,221551,141653,260118,106930,730252,2022-10-31
edf769437fed2b44,verizon ,2123495044,55826306,669694,30347,2180021391,2022-10-31
ff0cb265f4599d6a,mint,3595328297,114306719,0,0,3709635016,2022-10-31
10192a3de0147213,t-mobile,788437261,44716121,0,246,833153628,2022-10-31
5af49ff7c7957017,,787839,250666,445205,327262,1810972,2022-10-31
47a8c94aefb5bf09,t-mobile,0,0,0,0,0,2022-10-31
b8adc24dbf9fca0e,verizon ,406898893,6321115,178140,71929,413470077,2022-10-31
b97d83be18c1550f,mint,456907,165834,0,0,622741,2022-10-31
9d79adb28cb14b01,telus,431821518,34095835,0,0,465917353,2022-10-31
861203cc98f79dae,mint,354165,335851,728933,704230,2123179,2022-10-31
9aa27a12da34fcb9,,108479100,1375087,0,0,109854187,2022-10-31
ecb510528865adc4,verizon ,2281279154,35799870,2038163,392371,2319509558,2022-10-31
8f97784a3b122920,t-mobile,548521966,46383035,1089057,385688,596379746,2022-10-31
4e9615de48a4660d,t-mobile,846819,295821,552000,215800,1910440,2022-10-31
73e0b6f5d9d8c3bc,,36744,8129,0,0,44873,2022-10-31
6e89a7009602c543,at&t,651768,197257,416090,450459,1715574,2022-10-31
82764197458d32be,verizon ,813969945,18744366,1758567,160939,834633817,2022-10-31
78f887bcc59f963f,,743632,250568,0,0,994200,2022-10-31
e305a1ea7d2ac7ae,,194348806,11593214,0,0,205942020,2022-10-31
1393d2af914c93dc,mint,1342689480,87188915,42660,14704,1429935759,2022-10-31
733c7c1b6abac46b,verizon ,0,0,13686916,2079564,15766480,2022-10-31
78fce1bf9d8a7468,t-mobile,461909,280432,24595,427175,1194111,2022-10-31
710f86b280e51297,t-mobile,0,0,26715,8713,35428,2022-10-31
e13ecf39ec818f4e,verizon ,747724481,32337779,1915338,620718,782598316,2022-10-31
bcb58c7f37fb222f,verizon ,360111287,26851103,746508,52951,387761849,2022-10-31
764d13ea91a96253,,369,1794,0,0,2163,2022-10-31
8343327a4c33d7d3,,805549,505232,72636,10035,1393452,2022-10-31
fc296cb709524395,verizon ,0,0,58013475,2746389,60759864,2022-10-31
b7599091ac5a55e4,mint,53930037,624106,118446,150978,54823567,2022-10-31
8d1fab7ccb889b70,t-mobile,447572,158583,201003,66008,873166,2022-10-31
0987c55cb4dc7401,,41460,190870,104,104,232538,2022-10-31
d9d1b6bce7696864,t-mobile,2274798393,36591228,1423396,101627,2312914644,2022-10-31
8d1c4b46fa458189,at&t,597273,194571,31614779,1281454,33688077,2022-10-31
b1f29ca92d752b97,t-mobile,785156784,65780334,0,0,850937118,2022-10-31
05067e1640d2a2d5,t-mobile,580780656,64115903,1367242,685953,646949754,2022-10-31
561d0f6d9af14e54,mint,133822485,1584488,0,0,135406973,2022-10-31
e7984a8335f580af,mint,2962913346,47430300,163688,60913,3010568247,2022-10-31
2f73b023f454ff0f,t-mobile,155045807,2280574,28248,327706,157682335,2022-10-31
aba622277bd28fbe,mint,31333,10425,0,0,41758,2022-10-31
6d42b4f641ba23d3,,51979026,1221909,0,0,53200935,2022-10-31
83c065639b391fec,mint,392821456,39655659,14563,5523,432497201,2022-10-31
fa83acdc4d8290bd,t-mobile,1357183112,80660685,0,255,1437844052,2022-10-31
cdc5d52fc2359944,t-mobile,436343660,32359436,50499,24847,468778442,2022-10-31
faae05d813d558c5,,644861974,8483386,0,0,653345360,2022-10-31
d138169cf32e4382,t-mobile,172703443,1455963,0,0,174159406,2022-10-31
d69cb37016c4967e,mint,973820209,18711230,498,1462,992533399,2022-10-31
d01aa188a006f830,verizon ,16478770479,315120172,1092,997,16793892740,2022-10-31
0007b1992051435c,mint,790100,276041,467379,195916,1729436,2022-10-31
dcb55fccba6659cf,mint,360407825,33127197,108175,45745,393688942,2022-10-31
01297abd3aedf74d,mint,0,0,2031464,344142,2375606,2022-10-31
6f52563831a65e93,t-mobile,137709,616072,8929,2032,764742,2022-10-31
ee91e65a27dbba61,,98205604,1294689,0,0,99500293,2022-10-31
d9c984fadcd1378a,at&t,154439703,3202795,0,0,157642498,2022-10-31
92adf1eee20a993d,koodo,521329267,60898788,258079,89203,582575337,2022-10-31
ffb47503be377ab7,mint,19584,3577,0,0,23161,2022-10-31
3858bdb666c50c3a,mint,756671470,67387384,6672,1948,824067474,2022-10-31
a4da5b14da13294d,koodo,726766125,64650739,0,0,791416864,2022-10-31
40bd2f9b9b4654cc,,0,124,0,0,124,2022-10-31
6767a56731725b26,mint,721558905,72365267,11709,11178,793947059,2022-10-31
653c58ce7f07e5e8,mint,269806527,35640578,618073,166741,306231919,2022-10-31
751e51ab7b0fcdad,t-mobile,110348,186782,0,0,297130,2022-10-31
86a75704d0a5934c,,145510164,2404721,0,0,147914885,2022-10-31
6e762cdece9c25b9,,865574,249563,7418,1866,1124421,2022-10-31
4b0dcb143e19bbdd,verizon,427555,290412,211752,102843,1032562,2022-10-31
12c63cc4362fe137,mint,755135969,52461297,860487,115683,808573436,2022-10-31
aeb6f0817cc886f8,t-mobile,304344925,3544208,83415839,2507296,393812268,2022-10-31
4fad4fba7e94554b,t-mobile,50031795,1128566,0,0,51160361,2022-10-31
841964bc4377f931,mint,214258343,4229301,391,2390,218490425,2022-10-31
78e6483c89c7b63b,t-mobile,1146917654,73339307,0,0,1220256961,2022-10-31
9b69b9fb8200fa59,mint,928814,263366,0,0,1192180,2022-10-31
3ec5e63921179bd7,t-mobile,296605,100074,171600,60908,629187,2022-10-31
cff7b1f7c2e6cfe4,t-mobile,814730290,87276086,3439096,583054,906028526,2022-10-31
ef38fdf1fc37e51d,mint,766775,429530,805613,242516,2244434,2022-10-31
f48587e011278aa2,mint,581028897,18295674,0,0,599324571,2022-10-31
21cbc0b9a63e9bd8,mint,5077616974,124458995,63786,31270,5202171025,2022-10-31
c8ab9c3704eaa1e3,,1300223608,77254922,1086322,258602,1378823454,2022-10-31
8800aa5430f79a48,mint,919695144,14033299,21458,7361,933757262,2022-10-31
2a849a95530a9469,mint,3826839503,88270397,104,104,3915110108,2022-10-31
e531d8b5d54650ab,t-mobile,925764,281028,31645,9573,1248010,2022-10-31
ea3765d3963ae2b5,mint,0,0,1032557,345339,1377896,2022-10-31
57d9c505eea5f5a3,mint,675532,178774,360379,107198,1321883,2022-10-31
e806e9681f8c57dd,mint,846806,230835,0,0,1077641,2022-10-31
222d8ca084da42b5,mint,712272149,57524849,27489,17200,769841687,2022-10-31
50d271d380afe374,,137185038,1739815,0,0,138924853,2022-10-31
f4209841ed303612,t-mobile,475482,172433,113091,45731,806737,2022-10-31
57d5f334af4cef4b,mint,0,0,681745,115987,797732,2022-10-31
fc507056cceffc4e,,381053,309975,0,0,691028,2022-10-31
9d875f207c7e993a,t-mobile,856698,396653,104,104,1253559,2022-10-31
cddd09133e23c70b,,29798,10765,0,0,40563,2022-10-31
e0e9aec7ffb810c4,verizon ,322246940,8711952,1246262,80333,332285487,2022-10-31
173b4094b14b6e8f,mint,2376601984,96046640,1571307,181776,2474401707,2022-10-31
7b5161195d311daf,at&t,211040,71994,140935,62814,486783,2022-10-31
de9582bdb7a3d6e8,mint,275671599,22388440,733716,107833,298901588,2022-10-31
c0884db35985f2f7,mint,509654416,26626321,7019,2801,536290557,2022-10-31
73a829b5ca9ad237,,7756,17075,1313773,224341,1562945,2022-10-31
cea55b38ead78e38,at&t,2904674049,43615406,940000,182006,2949411461,2022-10-31
b01f62279bed4d7b,mint,1395315378,99611161,1142420,263322,1496332281,2022-10-31
97cb1ae6514b1fd9,t-mobile,495385328,41720369,1313761,188023,538607481,2022-10-31
f61b7958bd914a2f,t-mobile,698954113,33926521,20439,4194,732905267,2022-10-31
6caf364efbfdfbe2,mint,591363488,38635156,72247,430401,630501292,2022-10-31
8d0b151aa8814608,mint,861367184,31260632,713078,68308,893409202,2022-10-31
1d558ca9c3683a31,mint,80988,17386,78030,9666,186070,2022-10-31
afb3abcfaab6e214,,825953,226294,445399,129737,1627383,2022-10-31
0c12ef07f74835b5,at&t,0,0,0,0,0,2022-10-31
65758e4a8673166a,,632527508,29883857,0,0,662411365,2022-10-31
a7cf8d2bcd8f518d,t-mobile,0,0,0,0,0,2022-10-31
97182ff7ea77be06,t-mobile,0,0,0,0,0,2022-10-31
71a47056dd9e7e67,,300614952,5438114,0,0,306053066,2022-10-31
3bb8de17cce3d762,verizon wireless,387668491,5554440,39205903,904266,433333100,2022-10-31
5ae01e8a7e1d6131,verizon ,846346,251211,94381,40779,1232717,2022-10-31
195ed25e38fbab88,verizon ,6950256,320808,3494691,178562,10944317,2022-10-31
951f24bc4e916ef6,t-mobile,787754,240083,523758,169353,1720948,2022-10-31
da71e0144cc69c1f,t-mobile,886723536,11622660,725,5191,898352112,2022-10-31
e3832e81ffd12356,t-mobile,367679909,45725526,31893,8618,413445946,2022-10-31
e5d3b821317160c7,t-mobile,0,0,0,0,0,2022-10-31
b06f9a4338b242c8,,5895292447,129965896,1265623,258169,6026782135,2022-10-31
2b1f24cc06a00f72,t-mobile,0,0,33640,165969,199609,2022-10-31
f1581b0bd5b115ea,t-mobile,575658578,9946844,0,0,585605422,2022-10-31
00fc7f82c5318f0c,,55677855,1547198,0,0,57225053,2022-10-31
4b4d684c48ff1acc,,382192450,9061665,3751640,294145,395299900,2022-10-31
b5d9b0af4e115233,t-mobile,563304,163293,0,0,726597,2022-10-31
ab377e0bc2ad4583,t-mobile,0,0,0,0,0,2022-10-31
cb369c23075019ab,t-mobile,2032361872,87832434,385827,141250,2120721383,2022-10-31
261ef24933f830c8,,792622,201014,507417,146722,1647775,2022-10-31
6096235939764877,t-mobile,0,0,0,0,0,2022-10-31
a5e62412673b0e2a,,183154102,2915012,236720,86435,186392269,2022-10-31
9ccca69a0008b3ad,t-mobile,177475,60112,0,0,237587,2022-10-31
469acf9cd3bcd958,t-mobile,0,0,0,0,0,2022-10-31
d0ae837eff15bc1d,,125200012,2354800,35753,12714,127603279,2022-10-31
7c51f09acd5723bf,t-mobile,0,0,0,0,0,2022-10-31
1802fe60f668ca7b,t-mobile,626499,161704,20384,35075,843662,2022-10-31
19c2f84c55cba44e,t-mobile,2425104223,37876870,37135,12555,2463030783,2022-10-31
46f14c3995310376,t-mobile,444505209,25969385,95128,37373,470607095,2022-10-31
537effc1b687417f,t-mobile,237759506,4719463,7947,2791,242489707,2022-10-31
061b46ced08ea0f5,t-mobile,0,0,0,0,0,2022-10-31
42efd9960a594fd8,t-mobile,816590641,13424568,35051,9605,830059865,2022-10-31
53366208edb5bee2,at&t,0,0,0,0,0,2022-10-31
f85e920cd8f0656b,t-mobile,2295563788,85963692,0,0,2381527480,2022-10-31
deb50bc309672e58,,728052311,12256525,0,0,740308836,2022-10-31
635bca086cf8fca7,t-mobile,2095956609,89769701,0,0,2185726310,2022-10-31
0c58c6dd72ba93c4,at&t,357428529,11712105,1051,10446,369152131,2022-10-31
0a5580f21ec36431,,353378438,25069555,0,0,378447993,2022-10-31
9dced4b4e3a04f60,t-mobile,0,0,0,0,0,2022-10-31
fb88e508e3c93b76,verizon ,130136611,4267170,0,0,134403781,2022-10-31
34c8a212bfdef3bf,,190085,77909,0,0,267994,2022-10-31
60db4995f57eb25a,t-mobile,0,0,0,0,0,2022-10-31
472b4c9ab6a084ad,,1242855,224533,0,0,1467388,2022-10-31
3f71fdbf303da2e1,at&t,897573,345179,22566,7253,1272571,2022-10-31
cdc29c9596de5ca8,ting,0,0,0,0,0,2022-10-31
24df12fff2a29cc8,t-mobile,0,0,0,0,0,2022-10-31
9b12f77a46a32faf,verizon ,4106228032,129554219,6574,1793,4235790618,2022-10-31
f1236edf3a62a6aa,,837958612,18686479,0,0,856645091,2022-10-31
95326df0618f2d53,,230781386,33692643,0,0,264474029,2022-10-31
52193b4218e79db9,t-mobile,621259,188205,148670,58886,1017020,2022-10-31
cf0c7bc7e42635c2,t-mobile,333954952,6358627,0,0,340313579,2022-10-31
1e105d178f939284,gsma,857517,280203,0,0,1137720,2022-10-31
e45a52c0f284ec9d,t-mobile,242040159,17440123,1369444,268014,261117740,2022-10-31
b1213f25cbcd7861,t-mobile,237610305,4554416,70731,693900,242929352,2022-10-31
f15176e0b02f4c51,t-mobile,365961038,8218257,1425169,331877,375936341,2022-10-31
eee994f436cfc013,verizon ,2960134323,53834265,0,0,3013968588,2022-10-31
9dd4f38fdf6e2312,,23922,7748,1087599,351953,1471222,2022-10-31
f6542813470462b5,t-mobile,410903760,42696582,15759,18510,453634611,2022-10-31
7d946db61024dcfd,,292265,450627,0,0,742892,2022-10-31
239e66f511747892,t-mobile,906274905,88959448,2763350,354497,998352200,2022-10-31
c4bc3fd2b9efa005,t-mobile,617269746,51158304,1101749,162708,669692507,2022-10-31
a50e51210d8fe580,,372294456,42111426,36013,11653,414453548,2022-10-31
ecba7cc82a67a492,t-mobile,2453005275,60472654,131104,47391,2513656424,2022-10-31
c017666912878955,,0,0,895023,298865,1193888,2022-10-31
26b53be967b97282,,503743,149799,284999,105271,1043812,2022-10-31
812c232708e8fd2e,t-mobile,928600,400045,573343,247665,2149653,2022-10-31
fbc995f4f998529d,,995023,415884,0,0,1410907,2022-10-31
213b1de9dd85c822,mint,336127485,28927313,12077,2291,365069166,2022-10-31
cd833e8be3382990,,2307454219,64942692,1015833,206349,2373619093,2022-10-31
41b9fd8448a5dd9a,at&t,790304,294344,284898,112595,1482141,2022-10-31
850a778a4b3a2b83,,836623,253160,0,0,1089783,2022-10-31
05c1a23b77008fae,t-mobile,748360257,12490936,4280,166300,761021773,2022-10-31
5a44098e95aac0c1,t-mobile,378538784,7670657,12117,2259,386223817,2022-10-31
b207e8e59ead986b,cricket,13791850907,335271710,842330,158391,14128123338,2022-10-31
9b7edcd04255ed50,,22647,9884,0,0,32531,2022-10-31
3f3a05f99839dada,,122352238,1921005,0,0,124273243,2022-10-31
9a04a4c33955214d,verizon ,951393653,87842520,669617,44730,1039950520,2022-10-31
f952ced44b1517b5,t-mobile,2292100454,77815983,681576,167115,2370765128,2022-10-31
426a0ce4a8256359,at&t,288045,116922,69441,40015,514423,2022-10-31
9b377384282ec737,,156451907,27023817,8700,3214,183487638,2022-10-31
229eb7780457c4cc,at&t,0,0,0,0,0,2022-10-31
631b48a92c4dd934,t-mobile,79242,135074,218,2590,217124,2022-10-31
b316859b538051d1,,1014478,194402,0,0,1208880,2022-10-31
bd2dcf5bef4c5226,home,726190211,53946553,24280,13299,780174343,2022-10-31
a4bc8be786b8d970,at&t,142060,55681,0,0,197741,2022-10-31
9a9287ea56cc8b81,t-mobile,640719231,42604054,24919,12030,683360234,2022-10-31
a5dd6b50701c014d,ting,257659717,22008252,838397,143496,280649862,2022-10-31
cfb7d444513bb633,verizon ,20771201950,371920053,1493627,289843,21144905473,2022-10-31
26aac3df2eddefb3,verizon ,28743,196169,0,0,224912,2022-10-31
5296e493a69f7d0b,verizon ,2747031966,53018598,72144,56463,2800179171,2022-10-31
2a1e2d699c2299c0,t-mobile,732164,237060,378750,139560,1487534,2022-10-31
7d11ad82c37deab6,verizon ,986197,263904,322197,195985,1768283,2022-10-31
471263f43dde69e5,verizon ,5162524451,153571565,1680433,380238,5318156687,2022-10-31
42f85129ed409760,,856690,287243,0,0,1143933,2022-10-31
96903d92fce9a1ad,ting,642451292,57817913,40748,117576,700427529,2022-10-31
193f8c7ae4c325ee,mint,200689447,3321480,1866,22836,204035629,2022-10-31
4621365aff7a4604,,273539,80720,871528,377450,1603237,2022-10-31
ae593e9f176c45ca,,235796713,4716865,0,0,240513578,2022-10-31
79169658f899d821,t-mobile,0,0,0,0,0,2022-10-31
34e5ecaf77d3da4c,t-mobile,0,0,0,0,0,2022-10-31
7d9325b48971f8c5,,515583,133592,934637,300916,1884728,2022-10-31
7383b97d029ecba3,Verizon Wireless,0,0,0,0,0,2022-10-31
8ccdb40354711f80,t-mobile,0,0,0,0,0,2022-10-31
699691e9446834fc,Verizon ,22634103411,542143199,634187,25085,23176905882,2022-10-31
193d8e2fd2bc7c1d,verizon ,63472,20791,1009617,399848,1493728,2022-10-31
b365c91680c07736,verizon ,293734553,37080149,700179,54708,331569589,2022-10-31
16bcf66203b3a874,t-mobile,786565,276872,96286,31982,1191705,2022-10-31
485d08f3e77491ac,home,767501,215933,170937,149354,1303725,2022-10-31
8de4bb4c90b8b4e0,t-mobile,112379166,1719414,4453068,678986,119230634,2022-10-31
ac9a47b9696700ac,,224497136,3428451,33114381,466337,261506305,2022-10-31
7dfa3918c34ad8c4,metro by t-mobile,0,0,324253,79492,403745,2022-10-31
94cc918c7a7209d2,,22258,7106,0,0,29364,2022-10-31
da611688e597dee5,,143979,50635,0,0,194614,2022-10-31
88a597ccbdf36445,,567586881,15395723,0,0,582982604,2022-10-31
e508f58548138e96,t-mobile,872952,233848,225537,68195,1400532,2022-10-31
2727a78261a3df0c,,962226,264263,346173,123659,1696321,2022-10-31
8a5e6350e6443b3b,t-mobile,81562,33536,13250968,938784,14304850,2022-10-31
a6667f189144deb9,,5618029175,131065552,0,0,5749094727,2022-10-31
e15e3ba18c082f17,t-mobile,13967595727,235428941,39860062,2166487,14245051217,2022-10-31
cff1f1bef9468454,,892392,265184,578074,211012,1946662,2022-10-31
2745a170212caad7,t-mobile,754057573,11658905,0,656,765717134,2022-10-31
0634ba2e2563c525,t-mobile,3059907665,58595084,596747,43081,3119142577,2022-10-31
dc675119701d6ec0,t-mobile,382923084,38681739,212620,84667,421902110,2022-10-31
ac61378b2c43b202,,1326684578,43547239,1311660,302570,1371846047,2022-10-31
7ff34eb4684eb402,t-mobile,288403787,25844873,0,86685,314335345,2022-10-31
6cbe801ff9274540,at&t,534407,156175,34991,50804,776377,2022-10-31
9d46887a1c4ce1af,,833510,266364,122702,215029,1437605,2022-10-31
902b704ffb37b385,t-mobile,9415677955,208028419,196491,101736,9624004601,2022-10-31
1651642726ce817f,t-mobile,0,0,0,0,0,2022-10-31
7ac4c9204a5a11cc,t-mobile,0,0,0,0,0,2022-10-31
47293bcebd601b8c,at&t,0,0,0,0,0,2022-10-31
a020fd5806407420,t-mobile,0,0,0,0,0,2022-10-31
baeb0140bc544318,,22448285508,415202535,0,0,22863488043,2022-10-31
f8c7e89b0d8a68b5,verizon ,0,0,0,0,0,2022-10-31
2c19cc2dc9c940d6,t-mobile,291507617,38046009,589871,86031,330229528,2022-10-31
ae9d45101f520b36,,230630643,27555305,0,0,258185948,2022-10-31
e0c952a9ca58d2d7,,322817,95455,0,0,418272,2022-10-31
6dca597293bb5435,verizon ,131029046,2382174,30508,8460,133450188,2022-10-31
d022ad698ee8696b,verizon ,0,0,0,0,0,2022-10-31
f7a4b3f5a84f43b1,t-mobile,873987153,40934315,46534,24517,914992519,2022-10-31
f3d9e5c68d2d3b55,t-mobile,0,0,0,0,0,2022-10-31
6519d48431fcaf64,verizon ,0,0,0,0,0,2022-10-31
9e58550505304bcf,,598508454,70051596,1137633,250236,669947919,2022-10-31
03a902a2b3459847,,705271,215222,426278,390210,1736981,2022-10-31
c3b1f71dad00a04e,t-mobile,822441,219321,993,10676,1053431,2022-10-31
cd9fef19587da846,t-mobile,5240884280,107802271,0,0,5348686551,2022-10-31
f68d2591eaa449b5,t-mobile,4228360028,114446904,0,0,4342806932,2022-10-31
0a0f4adc7d5c5dc5,t-mobile,0,0,0,0,0,2022-10-31
8ac151c312bfc5ae,,1024450422,53125426,525998,175345,1078277191,2022-10-31
b4e2bc9b722dfae0,t-mobile,300805680,5095830,38404049,835079,345140638,2022-10-31
f5d00478e67f4533,at&t,1034169,512680,867062,332565,2746476,2022-10-31
8dbec254c8c53d42,t-mobile,508727412,62756529,890318,124762,572499021,2022-10-31
bc4d6b5cb5190380,t-mobile,6225914334,118114672,567065,96612,6344692683,2022-10-31
01989dea9574f3ed,mint,1456594794,73755119,918660,127301,1531395874,2022-10-31
99ba1babf451d161,,145682759,2690978,0,0,148373737,2022-10-31
1c46ecac8cbe34b9,,614146596,22331790,544,3643,636482573,2022-10-31
e551735124ea2dc2,,158466,43149,0,0,201615,2022-10-31
5ee77f84c2028591,verizon ,6458386,164491,12425,1729,6637031,2022-10-31
a68c6f42c59a9f12,t-mobile,480517739,10117353,16802,465672,491117566,2022-10-31
2ec50b87083c08cb,t-mobile,0,0,0,0,0,2022-10-31
b7f3a6b3d8ed9da2,mint,421710889,30432882,1105461,229999,453479231,2022-10-31
d9a393976f69e9fc,t-mobile,0,0,1313495,89050,1402545,2022-10-31
24d82a5065c7254a,verizon ,362695785,13506569,1078581,219146,377500081,2022-10-31
f6e8384b0f8c15b4,,884988,277223,0,0,1162211,2022-10-31
5dbfba37be9a71d7,t-mobile,0,0,0,0,0,2022-10-31
037a934e696d1aab,t-mobile,0,0,0,0,0,2022-10-31
ec212c5f44bcc87b,cc network,192299,206319,82583,402760,883961,2022-10-31
b25ad2639f463e80,verizon ,0,0,0,0,0,2022-10-31
80502f2fa91c64c1,mint,0,0,0,0,0,2022-10-31
85a0cb5a6b72e28a,at&t,721285421,69030775,859511,275600,791451307,2022-10-31
9b3d6c3e3e6d338f,t-mobile,3200496837,89895416,658762,34682,3291085697,2022-10-31
5dd626b8dafcf084,t-mobile,155855,62036,17285,12415,247591,2022-10-31
e17eb32643c5311d,at&t,0,0,20652226,1411968,22064194,2022-10-31
e3f56fe2dd5dfd40,verizon ,61355014975,973047652,14001,6032,62328082660,2022-10-31
db7e27b63de7f915,verizon ,10052021,408954,3808812,96928,14366715,2022-10-31
1653e659bdcb73c9,verizon ,0,0,391278138,7893314,399171452,2022-10-31
ef1a00a9a3b219ee,t-mobile,187204,70540,806484,244601,1308829,2022-10-31
d39e71fb7240848d,t-mobile,304224902,3499701,1100011,453109,309277723,2022-10-31
f32dd1fd1ea88b28,at&t,864064171,13050852,130166,39901,877285090,2022-10-31
a0f982bfd1236ee4,mint,707440,214726,200523,60652,1183341,2022-10-31
ae689abddb18c457,,362531982,8218623,11373038,388405,382512048,2022-10-31
8c45e2a12926a461,t-mobile,139299723,2188898,370138,181443,142040202,2022-10-31
8f9b19dbd34e1c69,mint,0,0,0,0,0,2022-10-31
5f8894d9bd628931,mint,440988401,42752878,76743,30828,483848850,2022-10-31
d0b09edaf4956489,,1108146098,58679864,0,0,1166825962,2022-10-31
cf8e580035894a98,mint,39146793,2004387,458546,145385,41755111,2022-10-31
cb41d2fff95f82ab,verizon ,313772,102782,784899,315938,1517391,2022-10-31
0da07c408e11fdd0,at&t,574728,169584,496753,341883,1582948,2022-10-31
de4375a0bfee6d25,verizon ,830252,121852,1361028,325443,2638575,2022-10-31
e07243169d3dbf30,at&t,0,0,4121667,325033,4446700,2022-10-31
cf773012a863ddd0,verizon ,835769011,46482640,106745,35751,882394147,2022-10-31
2d2134990929ee01,verizon ,40428605718,684392142,1258752,244179,41114500791,2022-10-31
08dd2873a465afc2,,26402,82010,0,0,108412,2022-10-31
cf36bf0163891552,ting,485069338,55751160,522125,162644,541505267,2022-10-31
771b81752d7dfb03,t-mobile,970721415,15742987,35148,17082,986516632,2022-10-31
dcee93fdd60c98e2,verizon ,795883,215168,696026,229876,1936953,2022-10-31
7596ee8676b9a370,t-mobile,1291044603,67388372,20280,6702,1358459957,2022-10-31
ca59e2d08f93a554,,763993,267453,127742,39014,1198202,2022-10-31
052f698fbb184011,mint,395378,134496,47793798,1159723,49483395,2022-10-31
715297ec198d8de6,mint,301444,81776,0,0,383220,2022-10-31
d24ff2cfaf262000,verizon ,641684964,61335314,1126344,196613,704343235,2022-10-31
57397050bbe5f70e,mint,613068,350562,30665,10817,1005112,2022-10-31
ad00032c48a0d1cb,home,190790791,2979346,190103,168279,194128519,2022-10-31
ea15a6fff6b87058,t-mobile,704937962,79490547,774749,102276,785305534,2022-10-31
7e72a2e98dc25d7a,mint,765640,282460,92393,34192,1174685,2022-10-31
087202ac070f0f0c,,2613128621,46827017,955589,219776,2661131003,2022-10-31
0d7dae72ee6b93ea,t-mobile,160654,59865,4320263,480689,5021471,2022-10-31
ff54367c56b2df04,mint,511,1732,157819,1661978,1822040,2022-10-31
666689f55448baa4,t-mobile,363515,290224,182765,64104,900608,2022-10-31
440672d6aab42a1b,t-mobile,795783,277199,14563,4639,1092184,2022-10-31
13dc0dcd5b77da97,,62866706,2468927,0,0,65335633,2022-10-31
6af774fa1f5da74c,mint,257183,525133,0,0,782316,2022-10-31
174f68cb11cf0e47,mint,137230924,3034832,0,0,140265756,2022-10-31
e94cee1f629a4d8f,,233813118,5145597,0,0,238958715,2022-10-31
9a4d0b53b0a9be9b,t-mobile,893085,314906,0,0,1207991,2022-10-31
e735e2f3e349dee2,t-mobile,1312299236,34039774,0,0,1346339010,2022-10-31
db49b285ae41646d,at&t,15333,3502,0,0,18835,2022-10-31
6e82e45207450334,verizon ,697996640,56155274,1041103,181513,755374530,2022-10-31
82376a5159824df4,verizon ,16433037228,277469649,18711,11184,16710536772,2022-10-31
207e52e79242fd56,mint,1351277125,54330076,193862,100251,1405901314,2022-10-31
a2ef8be06c776151,t-mobile,3086072885,81298139,147118,61614,3167579756,2022-10-31
82f67c0243f86b73,verizon ,706698,237815,8095913,412044,9452470,2022-10-31
2fc353e76b9fe3e4,,1118332021,58178465,0,0,1176510486,2022-10-31
668771a505ddd69b,,45002,125476,0,0,170478,2022-10-31
a55eac19a6dcc9f8,,460355568,27533214,626293,31026,488546101,2022-10-31
ff35118f989d7104,,15248,3552,0,0,18800,2022-10-31
cd39d1f653e9af96,t-mobile,727,12316,29848,19319,62210,2022-10-31
ef3e4924d5485c25,home,113886,42654,873224,363288,1393052,2022-10-31
9c35abcccb7bb9f9,mint,47408,127709,10321,3002,188440,2022-10-31
3b70f4b13aa007ed,home,94062604,2006175,754000,233736,97056515,2022-10-31
e894c104b48a6551,mint,614075190,37160415,175232,66055,651476892,2022-10-31
dd53feca36cb754e,mint,704101736,12249490,0,0,716351226,2022-10-31
2ad48a03f0033638,t-mobile,545109,163564,0,0,708673,2022-10-31
46f89486f529bf39,mint,169339,163951,120644,45893,499827,2022-10-31
7cedcd3f2f6b02a9,,3157493,85754,0,0,3243247,2022-10-31
48ed7a83bd91fbe7,mint,725771357,47296386,25768,6643,773100154,2022-10-31
32aed34dd63eecd2,mint,574579,341629,277840,138710,1332758,2022-10-31
81e00e1ce7189ac1,mint,83480908,1136276,9537,2723,84629444,2022-10-31
ccd4b4906c2661ef,t-mobile,392928,121748,411668,119630,1045974,2022-10-31
122cc3881d17a094,mint,352531,103087,240237,73204,769059,2022-10-31
97d0d3735aa27340,verizon ,409905465,9335400,1565171,227534,421033570,2022-10-31
82a1bcd29803d63d,verizon ,5081966174,134455901,1888526,315964,5218626565,2022-10-31
8d62cd9d6bf30413,,656871655,54327859,1114086,62597,712376197,2022-10-31
d6e923cf18a68ff3,,948533,285821,902091,314825,2451270,2022-10-31
9b76c0a541eca965,mint,766594,276902,248893,99304,1391693,2022-10-31
fdd2672fd3649916,t-mobile,0,0,859815,247474,1107289,2022-10-31
930cd72e67f3564a,home,557022224,50763977,1565027,204615,609555843,2022-10-31
e5bfbe540f6880a6,verizon ,557826597,39435877,916986,115511,598294971,2022-10-31
e4ee4399d59ed787,mint,84,84,494624,277734,772526,2022-10-31
60306194de153f4a,mint,11515096,441243,857253,449596,13263188,2022-10-31
072ebe97927e9c18,mint,696546,210593,0,0,907139,2022-10-31
c77adbeabc7cb42d,t-mobile,57294675,7558482,115380,35832,65004369,2022-10-31
2367996d9e048397,at&t,699143,206051,2095,36041,943330,2022-10-31
e4db8b5579d58548,home,801782,238032,713597,245882,1999293,2022-10-31
75443e11e63a4573,mint,126385,51202,0,0,177587,2022-10-31
14c844339ba90e8b,mint,16007,12439,188242,68009,284697,2022-10-31
0a5cf931dec27384,t-mobile,602000,186703,136866,51439,977008,2022-10-31
0286a5a8ec130a88,mint,0,0,131437451,4300790,135738241,2022-10-31
1bf8eb3fd43f9182,t-mobile,675204027,31873381,2395156,462406,709934970,2022-10-31
80ce8cec75de0136,mint,597263349,47309836,15994,15295,644604474,2022-10-31
d2cbc2b8fe5df968,mint,756764,238171,9003,2352,1006290,2022-10-31
64e7951e4d271c5a,t-mobile,1112561580,75202728,282172,74879,1188121359,2022-10-31
c965a55e52cff4f5,,1056405829,12728335,0,0,1069134164,2022-10-31
8d5f4579c792297a,mint,626462994,9350093,990,16533,635830610,2022-10-31
6e242900bf044aa3,mint,720562,240538,184147,60713,1205960,2022-10-31
07bb0d093248c6d8,mint,600264205,14956499,0,0,615220704,2022-10-31
b6099303737c3b45,mint,28724,11269,0,0,39993,2022-10-31
3ca357c7ee17da82,mint,1197732411,69684327,978365,156468,1268551571,2022-10-31
fdc5dc5b5d303de7,mint,274438949,9947729,102842,36485,284526005,2022-10-31
749e423b0028823f,,381985408,5029122,0,0,387014530,2022-10-31
7d0399d31a127d89,,124808287,2831659,0,0,127639946,2022-10-31
fb3748c0b95e1047,,268976653,12410744,0,0,281387397,2022-10-31
25c1e766b986d494,t-mobile,676547756,35592349,0,1464,712141569,2022-10-31
00da7650c859fe46,gci,32063,7128,84,84,39359,2022-10-31
7e400301e2aff55b,mint,1980144641,28301518,0,0,2008446159,2022-10-31
813ed72ad58c840f,mint,19390962,1524821,0,0,20915783,2022-10-31
2b76ef21f0972366,gsma,729007464,74153564,112808,32553,803306389,2022-10-31
becd5db826b0aaf6,t-mobile,420257039,35272972,22015448,1148238,478693697,2022-10-31
7fbd8f671010def9,pure talk,1341797789,20158335,100546,29879,1362086549,2022-10-31
872ad9d67dbfeacb,mint,668121493,7338134,0,0,675459627,2022-10-31
8b98defaabed34b4,mint,382244852,11769385,66001,11157,394091395,2022-10-31
66bd1aeff2bc3e6f,home,92906,134190,19652752,429356,20309204,2022-10-31
3d82f84becf6b4ea,mint,0,0,80212020,1357827,81569847,2022-10-31
4b74c93a2c56e9b2,mint,898766447,65823506,638864,29991,965258808,2022-10-31
f86fc5bd3a88ac38,mint,885382669,69452619,362369,81001,955278658,2022-10-31
27f726c67da9352a,,13790,14557,0,0,28347,2022-10-31
89c77b957c437c1d,mint,49843864,1049592,0,0,50893456,2022-10-31
b1d457ad618100b4,ting,520584955,52474678,0,0,573059633,2022-10-31
bd00e80361c1ce67,at&t,149759084,3640367,0,0,153399451,2022-10-31
3982f2beb423d442,,73723927,1634869,0,0,75358796,2022-10-31
f5aab0f34f0dd665,pure talk,40450525,1395504,0,0,41846029,2022-10-31
f6f2f7f0a0d7a171,,484715675,8645763,0,0,493361438,2022-10-31
3ad87f205cf8447f,at&t,1868978,173844,0,0,2042822,2022-10-31
ba457b5b3561c13f,mint,139910660,1550840,786678,91576,142339754,2022-10-31
a077fcf7f22a1aa0,,609259999,9452755,0,0,618712754,2022-10-31
70fa29f4c7cd28c2,t-mobile,563560904,14594893,104,104,578156005,2022-10-31
2b84cd76db0dc53e,mint,415102851,7370807,59824,22088,422555570,2022-10-31
91d7e55febd994de,t-mobile,1142560,246977,101906,13209,1504652,2022-10-31
b4876257cf7597fb,t-mobile,674481327,72105859,6935,2284,746596405,2022-10-31
86b66235a8f97753,mint,669014,291137,0,0,960151,2022-10-31
0cd832200a023594,t-mobile,32886038,595783,829042,318297,34629160,2022-10-31
8f8fdf771a601eeb,,577851,178614,707753,220428,1684646,2022-10-31
88921f0fc3957648,t-mobile,29716348530,428765534,31241,303186,30145448491,2022-10-31
8f9446c2f7df6146,,794275,274434,0,0,1068709,2022-10-31
da8581c442c5c092,,170721,140043,0,0,310764,2022-10-31
4e8ff37c15a50e46,verizon ,3175446256,59083650,55933933,1930012,3292393851,2022-10-31
5fdbc370f739f150,mint,0,0,986930,338086,1325016,2022-10-31
107200ad87979fc6,mint,0,0,1291388,92163,1383551,2022-10-31
ecfeb5a9e958661e,gsma,256023335,9590448,65605,125526,265804914,2022-10-31
576cdd168325b31d,mint,626067,192105,538897,182135,1539204,2022-10-31
3e3a471bc1230afd,verizon ,12930503090,233555296,647856,63526,13164769768,2022-10-31
f0c1d9b97a6ee989,verizon ,150534719,2419202,196613,122055,153272589,2022-10-31
f0e8423ed17e6785,mint,877845827,90043144,0,0,967888971,2022-10-31
7e7369636878fe47,t-mobile,682051,208525,11554,3401,905531,2022-10-31
a869c1c7c1f176d1,,613593709,52752819,0,0,666346528,2022-10-31
c65e2ee05fd1909e,verizon ,541319169,58073401,958775,139997,600491342,2022-10-31
3d25a70efe370e37,t-mobile,810239,235716,144083,38089,1228127,2022-10-31
ed2c5e4c5b62cd06,verizon ,851662,225560,233064,155154,1465440,2022-10-31
48223e3a36498e35,,667707,369504,0,84,1037295,2022-10-31
1ebeb8b029bb5a70,t-mobile,89509,19939,0,82,109530,2022-10-31
554a777f34531072,mint,624319208,42456575,113339,45189,666934311,2022-10-31
a873175ffde2f63d,verizon ,8968000435,212541475,1062713,179690,9181784313,2022-10-31
f5581501aa89347c,verizon ,696973,192760,870628,300302,2060663,2022-10-31
df0d5acc3b46fae9,at&t,375986,206171,100996,69621,752774,2022-10-31
e914b54496322d0f,,766579,244906,545637,188151,1745273,2022-10-31
9df7be423d6434ee,,736282,280570,704110,251372,1972334,2022-10-31
275140c6151e9b0e,t-mobile,123226045,2978741,14005,2447,126221238,2022-10-31
353f1bc5f0bc52f9,t-mobile,19945888,1848339,119177,40244,21953648,2022-10-31
319ceb053ff0e097,,1034054808,68436589,0,0,1102491397,2022-10-31
2b6af2138e5cce21,t-mobile,15321361001,293175405,49019,19166,15614604591,2022-10-31
e13f42b3f22cbfe2,at&t,877232,233073,15280,3850,1129435,2022-10-31
8cd85d679b1090ea,,570183,172966,0,0,743149,2022-10-31
4e3004125dbfc128,mint,746060997,22233390,0,255,768294642,2022-10-31
e93603756c4a2651,at&t,21589,7135,0,0,28724,2022-10-31
6f7f20039aa932b7,t-mobile,512619516,59869401,984741,160017,573633675,2022-10-31
26d5429aba73ee21,mint,635150,186860,34035,133262,989307,2022-10-31
144f212587023e8d,mint,351277470,8064062,6362,1984,359349878,2022-10-31
7afddbe07e73932b,,7493,2303,0,0,9796,2022-10-31
70f7d5bc8a3690d5,mint,257238,76137,0,0,333375,2022-10-31
b18ae630685f6ce1,mint,24715,8677,0,0,33392,2022-10-31
6585c8d15692b895,verizon ,183407928,2904984,131894501,3937963,322145376,2022-10-31
cefd4ba7724f34bb,,660477,175971,829834,284848,1951130,2022-10-31
b45bf7bea9628c5e,mint,235112590,13835196,0,0,248947786,2022-10-31
0aa0d00559b3b053,mint,3276082832,120451980,13547,4352,3396552711,2022-10-31
9d9920ee5a29b71f,t-mobile,651321102,10095990,15444,7576,661440112,2022-10-31
51b190e5cf16ad7d,mint,892548115,67763176,66786,25952,960404029,2022-10-31
167dfebe2978b569,metro by t-mobile,880540,343357,0,0,1223897,2022-10-31
3256dc933e7ec406,,714924,275880,0,0,990804,2022-10-31
2c8e82ade4e3ac14,mint,802975289,55932317,81124,57648,859046378,2022-10-31
39b7235c0b54bf4b,,250456,74102,0,0,324558,2022-10-31
09b0fc671cf18396,home,378248131,5418626,201329,68777,383936863,2022-10-31
3396cb3da915a7e7,mint,743364,240403,240590,75321,1299678,2022-10-31
994e14ae57e01b55,t-mobile,26226,139134,233503,78627,477490,2022-10-31
b07a93cff486b044,mint,457276001,6031387,51105,123525,463482018,2022-10-31
e7b9614f844c53b1,t-mobile,1240163238,49199500,732990,70890,1290166618,2022-10-31
474dbd6017badf2a,mint,220543,81866,150121,42567,495097,2022-10-31
a7aa0b2cfb15aa19,mint,921798,404328,21442,5640,1353208,2022-10-31
fce04db4ae5bc230,,263649717,27685416,802581,105040,292242754,2022-10-31
af79af81ab00c4f6,,31863,6859,0,0,38722,2022-10-31
1c4ae1b8ba2c6c23,,27982924,862245,0,0,28845169,2022-10-31
ad70fdf7c4c78cee,mint,840475,247146,4122172,218136,5427929,2022-10-31
ec2d5a94a105aa70,,246961091,9449543,0,0,256410634,2022-10-31
3269a5899b862456,t-mobile,462054884,16713071,2073176,358180,481199311,2022-10-31
c3cf8823ba56090f,t-mobile,430995163,53922522,214246,76869,485208800,2022-10-31
f6570ed5ccac9511,mint,611280805,43012085,799244,91876,655184010,2022-10-31
dda218209c80ee75,mint,716950444,62847292,0,0,779797736,2022-10-31
aaf7da6aa611710f,t-mobile,0,124,255898,75127,331149,2022-10-31
d9c90b3775264075,mint,970626,277204,34544,12170,1294544,2022-10-31
0946cb15da2ae3eb,mint,1003093,194709,33869,9800,1241471,2022-10-31
f670aea77f264c5c,t-mobile,116915605,13589375,0,0,130504980,2022-10-31
7b615f8613460626,t-mobile,187125008,6229276,1371356,335223,195060863,2022-10-31
52a6023e0b08d188,mint,805973,222369,294192,90736,1413270,2022-10-31
ba09d72ddcc8175f,t-mobile,609086,169209,0,0,778295,2022-10-31
9d738aa44a0c4102,t-mobile,166180,53079,652514,209781,1081554,2022-10-31
6b53efc2d083b028,mint,1196832553,89809536,6853,2199,1286651141,2022-10-31
292f8cbef70c645c,t-mobile,569943,204786,53656805,1380140,55811674,2022-10-31
333301b4fc7842c3,mint,0,0,52764123,1444757,54208880,2022-10-31
2b256bd1afdca9b8,mint,244405635,3645185,550,9457,248060827,2022-10-31
29e407aae08b5a4a,,41716748,1079306,0,0,42796054,2022-10-31
4bce435ef5debc9c,gsma,1177584448,80108065,1569009,188965,1259450487,2022-10-31
501e2eb8954648f5,t-mobile,84,84,104,104,376,2022-10-31
7886004bba5f4251,mint,660319,200911,0,0,861230,2022-10-31
4db914c682de81fa,mint,210819814,2402852,849215,282307,214354188,2022-10-31
d09bb3ab58239b21,t-mobile,927737711,60517482,191821,79828,988526842,2022-10-31
64f445a92db573eb,metro by t-mobile,1063426525,75742141,104,104,1139168874,2022-10-31
3440bb47c2e514f8,t-mobile,442327,118107,24930,6871,592235,2022-10-31
88fdf7783553f56f,mint,710423397,15387641,198400,69074,726078512,2022-10-31
d3b2e075bb42fc7e,mint,196693,59576,91938,11447,359654,2022-10-31
e6f7c68551eb4e19,mint,863956831,44887714,721936,132993,909699474,2022-10-31
2bc8505ecb0673fb,mint,2097102054,54310907,0,0,2151412961,2022-10-31
29778d02bdfcdec3,,73509420,1415153,0,0,74924573,2022-10-31
dc204339c4924da7,mint,22267,7843,1020973,182883,1233966,2022-10-31
5cf0ed06d16c360d,,22554,6357,0,0,28911,2022-10-31
2804f69f4611dfdd,mint,222010468,9830633,1548975,239575,233629651,2022-10-31
c30535c757038d78,mint,405130850,5205188,0,0,410336038,2022-10-31
baa2d6c489e7f456,mint,4156628529,67797674,0,0,4224426203,2022-10-31
a306f06763eed885,mint,634549046,30387542,0,0,664936588,2022-10-31
141515deb9dd7c83,mint,546248729,63891646,805,7084,610148264,2022-10-31
8ea288b9a479ef95,mint,818259933,29731608,5,3,847991549,2022-10-31
e54cc499c38c16cb,mint,144303256,2189416,55093157,1813868,203399697,2022-10-31
a1c77074f0ba0b37,mint,131636098,9697842,0,0,141333940,2022-10-31
f883f918b4218330,mint,1017147,208655,614,7542,1233958,2022-10-31
9858d32316437c92,t-mobile,44424,48170,0,0,92594,2022-10-31
4d34f096937980ae,t-mobile,557697983,9392406,45,35,567090469,2022-10-31
c837d1b5ad5b4d12,mint,223559170,3046591,41062,14163,226660986,2022-10-31
f17890c9c78016dc,metro by t-mobile,14139,4063,15065,3450,36717,2022-10-31
f9ee273cad983b89,mint,639045214,51474205,184339,65944,690769702,2022-10-31
025f620ba9298c5d,,73544236,1184751,0,0,74728987,2022-10-31
7391618c1278801d,mint,0,0,916897,173447,1090344,2022-10-31
54d5fbb086b2c8fa,mint,277435914,3429190,0,0,280865104,2022-10-31
070419e06df40c8c,,804106,241310,0,0,1045416,2022-10-31
cc20a233935c3d31,t-mobile,301267083,7755448,0,0,309022531,2022-10-31
333653da4ce80afb,,148287933,2743968,0,0,151031901,2022-10-31
13618c5c2336b0b4,t-mobile,1202620209,70591184,13691,4317,1273229401,2022-10-31
92c76ede574e1213,mint,567020966,56709956,22410,7512,623760844,2022-10-31
598b7c12de9f4345,t-mobile,3051382277,80546791,109270,42542,3132080880,2022-10-31
15aff3ae1fa6a427,t-mobile,691543931,50066556,113,85,741610685,2022-10-31
34bec7cb8d2d92a2,,3717807103,55097685,135762582,1375700,3910043070,2022-10-31
4e4069b8db6ba343,mint,750564981,30844305,136381,49237,781594904,2022-10-31
df4785dc53456caa,mint,3325058064,113018667,0,0,3438076731,2022-10-31
4b58e2a2a244730e,t-mobile,1435990739,59928329,6826,2152,1495928046,2022-10-31
8fd4d4106721f833,t-mobile,744082859,9571061,1275838,75509,755005267,2022-10-31
5f11a4636356cab9,us  mobile,227690931,18790849,973927,161018,247616725,2022-10-31
1c21baf21b5dd35e,t-mobile,998781654,78988397,8441,2341,1077780833,2022-10-31
55df0655ae5e3f00,t-mobile,3710872525,108377270,6972,2356,3819259123,2022-10-31
fda367396cd7e3b8,t-mobile,2982189824,106248885,17796,10142,3088466647,2022-10-31
09464cf42b8e5721,verizon ,457621188,35491087,609604,14169,493736048,2022-10-31
595455b572c87607,at&t,834210530,87284511,95935,38455,921629431,2022-10-31
da31179eab302a77,verizon ,583898979,21780843,675,255,605680752,2022-10-31
e2da7b727ff49437,verizon ,317548521,45804301,1636828,231101,365220751,2022-10-31
8aada32ff1134e23,verizon ,990640363,70864102,1869194,222009,1063595668,2022-10-31
d9f66a2ccec93f73,verizon ,1139721770,79425063,926187,119898,1220192918,2022-10-31
95db30ccb1dc56ac,verizon wireless,1378090041,69997031,136730,45873,1448269675,2022-10-31
f9d452197f535add,verizon ,1056632525,67942765,660734,43907,1125279931,2022-10-31
f37dc0bf4732945a,verizon ,1013157798,68397432,855513,109568,1082520311,2022-10-31
6e931d05fa13e1a6,t-mobile,467659442,60476056,12144,1672,528149314,2022-10-31
986e4ff5430845b1,mint,637500643,43718686,34333,11266,681264928,2022-10-31
df86b81508144ce1,,1150477042,66741232,31555,10148,1217259977,2022-10-31
18c9d88fd97e4ce2,mint,114392310,10569613,0,531,124962454,2022-10-31
97e073c4a97ed8f6,mint,1021937817,55873939,1957727,396487,1080165970,2022-10-31
0b3d1b62fbe7e734,,933539,257621,238182,69850,1499192,2022-10-31
8fd889fddc393923,mint,1687607354,73807470,8368,6106,1761429298,2022-10-31
a6820deb538c6eed,home,3978566205,104208673,1079549,184185,4084038612,2022-10-31
b6561e70fec0fa69,home,183137306,22400219,1064637,208884,206811046,2022-10-31
42059cb5fc607519,t-mobile,276294033,12448228,1174827,232523,290149611,2022-10-31
e54c8cc00d05b89e,mint,0,0,72553,22289,94842,2022-10-31
30919556a7938a70,,7100465767,169530592,94033,33838,7270124230,2022-10-31
73c8ec38a79d9412,mint,631360686,49445407,1274039,70320,682150452,2022-10-31
da3f96afe53dbab6,mint,392752779,12677750,0,0,405430529,2022-10-31
c77f83671988ef50,t-mobile,331492661,21716114,0,0,353208775,2022-10-31
346d202a1fa9e81e,t-mobile,858105548,34369852,892573,142499,893510472,2022-10-31
f384925173543d43,,765454,221498,0,0,986952,2022-10-31
df439c52b76d2108,,92568270,1437681,0,0,94005951,2022-10-31
2cf6e9b46019f1e3,ting,563592525,27555580,526036,207418,591881559,2022-10-31
944cde45c611d469,t-mobile,659415323,51756991,811799,254750,712238863,2022-10-31
6369d1425fcd45ae,t-mobile,690967709,33106362,1994871,317606,726386548,2022-10-31
49c6168fbf00d540,,1471368,247581,243995,82293,2045237,2022-10-31
592a49f84b58065d,at&t,1547145886,37775190,1515335,352013,1586788424,2022-10-31
4a8cf1c6a0a00150,at&t,263057048,34038051,957089,128366,298180554,2022-10-31
6f0d16e507ea87a1,at&t,624431088,52878218,649791,95120,678054217,2022-10-31
3ec5d8e426736461,verizon ,30396101,2466832,84,84,32863101,2022-10-31
f9ed31c175db51fc,mint,792473,200989,1021956,295601,2311019,2022-10-31
2a93709756e2cf0c,mint,688878753,55333148,84465,28844,744325210,2022-10-31
7c539018073a53fc,verizon ,1346432184,74205810,6661,1793,1420646448,2022-10-31
8d519dcc4cefd997,at&t,142614765,6027591,84,84,148642524,2022-10-31
5b79557b38713584,verizon ,718264511,64328160,1861418,259956,784714045,2022-10-31
8eaf727852d5b07b,verizon ,1125532419,64502804,46965,14813,1190097001,2022-10-31
52c958ee10b4846c,at&t,194388045,11883391,692160,237858,207201454,2022-10-31
2fdc55eeec149501,at&t,786755147,66751554,6621,1649,853514971,2022-10-31
f294398d828a933c,verizon ,678089338,36482545,1318975,87279,715978137,2022-10-31
764d96c85a80fe33,verizon ,275989435,3846009,95025,28134,279958603,2022-10-31
d89a055ac50235ef,at&t,315542297,14282151,13296,3665,329841409,2022-10-31
070fc1ddc78d2d71,mint,791014495,18888105,6621,1753,809910974,2022-10-31
242c3808887dcb41,verizon ,65081,187935,894523,252080,1399619,2022-10-31
d42e50c1fc08b64e,verizon ,809567938,58782643,664249,100220,869115050,2022-10-31
0c0ed620bafe8198,verizon ,1112268396,28841430,2008128,315550,1143433504,2022-10-31
d0f646e016af86f8,,656442120,37863875,557556,265760,695129311,2022-10-31
bf800dc69f947662,verizon ,959065608,67987040,283068,87219,1027422935,2022-10-31
774cf537b4fadd5b,verizon ,1239643074,63760415,236766,72617,1303712872,2022-10-31
79018aae79245e0e,cricket,1129440526,50359301,2985981,700169,1183485977,2022-10-31
f4076d2d9595e2a1,t-mobile,871419820,45919094,1958394,275633,919572941,2022-10-31
ca519057bd95288a,at&t,557922142,54353813,4813,8721,612289489,2022-10-31
dcbb3f872b985566,verizon ,569152066,48053468,655929,34029,617895492,2022-10-31
48f94cb1c7c08046,verizon ,1570930764,63140817,1843612,216610,1636131803,2022-10-31
8a309c93a3a45751,mint,112978803,2121510,0,0,115100313,2022-10-31
9ef7fb02b0af1941,mint,0,0,32853,8197,41050,2022-10-31
781f9c2bc264fbbf,verizon ,198915065,5420257,1338311,83683,205757316,2022-10-31
51809764fee14a9a,Â ,13899595,3409491,729036,83630,18121752,2022-10-31
d4ffac163ea75fd5,t-mobile,114909052,3181275,515677,55662,118661666,2022-10-31
db98e2503807cd93,t-mobile,393269980,37890061,0,0,431160041,2022-10-31
d4ebd4a4f3139c22,mint,1060739,214627,14328,2435,1292129,2022-10-31
2e6c251ec3038666,t-mobile,752176629,48042436,152,741,800219958,2022-10-31
b891fcee7bccc3d2,t-mobile,302278,294872,670030,206398,1473578,2022-10-31
e97dcd154e37bd69,mint,310605782,13579214,0,0,324184996,2022-10-31
c8b23ea87c18e08b,,860680,271311,55918,17463,1205372,2022-10-31
08d3acc81e5a1bf7,mint,186799519,7999292,19341,5088,194823240,2022-10-31
283da8b2cb4c4af5,mint,1046420559,57813025,953019,165900,1105352503,2022-10-31
d39e7433fa271860,t-mobile,749262563,56032364,163645,23312,805481884,2022-10-31
6e3c891cf7e4da09,mint,3550530666,121907353,3481229,718266,3676637514,2022-10-31
632d050c19b0cd92,,585204,185519,0,1476,772199,2022-10-31
a8c31bd73a73ad5b,,589360,138893,0,0,728253,2022-10-31
a448c082b8b4e51e,,299597045,23520179,54520,18939,323190683,2022-10-31
a0c48a50862b8f48,mint,0,0,119918089,2272762,122190851,2022-10-31
1388f061269a247e,mint,559269438,35648769,171082,62432,595151721,2022-10-31
03e019bf7f42778a,mint,608306864,24619043,20857,7763,632954527,2022-10-31
9bc1d8b304c26cfc,mint,786071410,36592998,45903,20648,822730959,2022-10-31
19fa1372eb6bb946,mint,1067475701,45207648,21084,6955,1112711388,2022-10-31
ee62b5c820b0594e,,88424494,2075624,0,0,90500118,2022-10-31
7e0377af74ae502f,t-mobile,632653653,45443207,0,0,678096860,2022-10-31
96027b5ea55f62a1,mint,563917524,46460299,36060,20662,610434545,2022-10-31
b5edcede7a7f7812,mint,293201104,20115650,568789,39970,313925513,2022-10-31
d2dfa9744c6bebb5,t-mobile,888238161,95114756,13582,4352,983370851,2022-10-31
fdcd986284207ce5,mint,1014226203,67376317,34084,11999,1081648603,2022-10-31
15a007fde3be951d,mint,8170,2520,26837,176863,214390,2022-10-31
bfbd766c9a1d5fbd,,308129129,3208147,0,0,311337276,2022-10-31
57b12eaddf2df1d1,t-mobile,52074219,956938,45124,406341,53482622,2022-10-31
a92b860fd50c9e70,,126202,30840,0,0,157042,2022-10-31
3add4deac38fa62b,mint,3126580787,106091880,609378,14365,3233296410,2022-10-31
d720fe2d78823b59,mint,967150934,39213730,1337751,784160,1008486575,2022-10-31
ef980a9c9bd2fe86,mint,650521218,54322701,28971,10925,704883815,2022-10-31
b019172e4a5611f0,mint,0,0,657263,55326,712589,2022-10-31
6537edb702636be6,mint,785683321,48900080,0,0,834583401,2022-10-31
bb4166a50b15d372,t-mobile,283301,753462,0,0,1036763,2022-10-31
4ececb526620e1a2,t-mobile,2632063079,91269302,51022,12711,2723396114,2022-10-31
ebff83cf40c2478c,mint,3933466454,93357164,1652,7541,4026832811,2022-10-31
d8284f2e11eae6b6,verizon ,3443082560,85993625,837530,84423,3529998138,2022-10-31
57fa2b6a66fc409c,verizon ,263174640,33912573,34436,11226,297132875,2022-10-31
0da704d1454450a9,verizon ,0,0,133933917,3820217,137754134,2022-10-31
d6ddadba82101247,verizon ,915306612,75393302,1950627,278123,992928664,2022-10-31
df996f1bc1a53d42,visible,381683853,41894631,801990,82024,424462498,2022-10-31
a52dff2b7a6da007,verizon ,701468178,53815937,1375808,121074,756780997,2022-10-31
c92f70229e415e56,verizon ,905155,265208,284528,304393,1759284,2022-10-31
2013194d9e29a336,verizon ,389314283,13542467,977179,118055,403951984,2022-10-31
7adc242d2c6034fd,t-mobile,619316901,52550235,6565,1948,671875649,2022-10-31
27478d1f00d13981,t-mobile,3106069491,52935771,85374,162468,3159253104,2022-10-31
358f1c8037cffc7c,mint,0,0,870011,268255,1138266,2022-10-31
27684263c985ed92,mint,0,0,20656,7511,28167,2022-10-31
3496fbee724b55e0,t-mobile,1553361720,96777350,9758,7791,1650156619,2022-10-31
c4f11e83109806c2,t-mobile,1010920764,52560628,96108,36680,1063614180,2022-10-31
a5bcf49aeaf29b24,mint,843957960,76991813,695306,51358,921696437,2022-10-31
37e0b30fa760800d,,1602917924,19574280,0,0,1622492204,2022-10-31
9ab50f41e18f3244,t-mobile,0,0,665840,201290,867130,2022-10-31
1e73a8981ff81f87,mint,730976,209536,85746,34637,1060895,2022-10-31
dd88164e564df2ca,mint,395886331,33834911,0,0,429721242,2022-10-31
3952086e71377acd,,42965180,3975386,88838,31796,47061200,2022-10-31
897f86682be53408,mint,84475612,2105066,0,0,86580678,2022-10-31
48bb1bef9634590e,mint,1060987299,55283733,428600,176314,1116875946,2022-10-31
63928bc62808ae25,mint,898110,231188,0,0,1129298,2022-10-31
f34ae588d68c11fc,t-mobile,550207956,59672979,71755,32462,609985152,2022-10-31
6c6609a08c3bfea0,t-mobile,0,0,973824,314664,1288488,2022-10-31
46d0a8edbe33886c,,13937,5692,0,0,19629,2022-10-31
227ed5bc7467d2c3,mint,1335539114,34534490,38120,22095,1370133819,2022-10-31
2aeb908acf37d792,at&t,0,0,1095176,106147,1201323,2022-10-31
705779486d82cb62,at&t,0,0,998245,188011,1186256,2022-10-31
fc9129fe662b6fbb,at&t,686714733,34069430,170376,60507,721015046,2022-10-31
78437428b38e924c,at&t,0,0,671850,76076,747926,2022-10-31
8f75969cdd9ac057,verizon ,1239740926,69242563,6661,1793,1308991943,2022-10-31
dd7df73774fc40f1,verizon ,4877497798,120649702,2141554,370710,5000659764,2022-10-31
b758a0696d01ce2b,,1140070742,63704408,668190,87906,1204531246,2022-10-31
3f0a9a6b42adf3fb,mint,482713141,40272157,6329,1649,522993276,2022-10-31
2827998dfd34ce84,mint,1349887025,63529665,14965,5216,1413436871,2022-10-31
63b6f0e969212a1f,at&t,1104740249,85970515,6963,2371,1190720098,2022-10-31
fcb725b06420a31f,at&t,1376764721,43313870,0,390,1420078981,2022-10-31
f0723b8c99b24156,red pocket,2646032296,26534898,1955883,599238,2675122315,2022-10-31
9ac0997a203a3ada,us  mobile,1421830274,50544962,45861,17558,1472438655,2022-10-31
246b4108f062c384,verizon ,67094,20016,998442,222744,1308296,2022-10-31
c6c931dce93dfa0e,verizon ,871320191,55399130,84032,25866,926829219,2022-10-31
3775a04ea18133af,mint,21041,12887,0,0,33928,2022-10-31
7305da254ddab2b2,verizon ,880642332,98450739,1274719,67072,980434862,2022-10-31
31175196031da3a8,at&t,489960442,19365143,0,135,509325720,2022-10-31
987ada68e84e3bf7,at&t,550335639,64428866,2044516,333875,617142896,2022-10-31
21a84dc1a310c252,verizon ,0,0,2064767,562585,2627352,2022-10-31
930ce842cd9940f6,verizon ,55159776,8252797,8751,4386,63425710,2022-10-31
d660d2d2ce47f0a9,verizon ,513765719,47921653,13475,3203,561704050,2022-10-31
5ed89ebc3e8585ff,,96133715,13736801,0,0,109870516,2022-10-31
fe1d59eaa58bcedc,verizon ,562858573,92181369,851672,92605,655984219,2022-10-31
386de7bebfb0ec41,verizon ,888844675,56107562,6661,1460,944960358,2022-10-31
dbc242dde9854f68,cricket,234254867,26395948,13688,4551,260669054,2022-10-31
ffd5c6ed3a8ffb18,,1338674882,28465270,0,0,1367140152,2022-10-31
97e8f4eecf38a1e5,verizon ,0,0,2184609,269690,2454299,2022-10-31
bfb60534dbf6cc45,,144215428,1584844,0,0,145800272,2022-10-31
a16b0560b3738a19,verizon ,608710021,71168589,395276,118200,680392086,2022-10-31
352a2485846d9ee7,verizon ,1416420225,72908709,1964099,356202,1491649235,2022-10-31
259fbbfe168421a5,t-mobile,929954238,44928622,1949594,311632,977144086,2022-10-31
17822f685e6978e2,t-mobile,0,0,892935,154198,1047133,2022-10-31
06cfd1833cfe7023,at&t,858986185,61407661,1201945,204091,921799882,2022-10-31
0ce79159d865392a,verizon ,825268767,64373758,1266168,44265,890952958,2022-10-31
a6fe0d265abf6848,mint,1060903091,62750905,157704,55883,1123867583,2022-10-31
6348c73873824995,mint,1259949321,30820884,6493,1961,1290778659,2022-10-31
c4bf9ee298ff7076,mint,2675990174,68362132,642572,30223,2745025101,2022-10-31
cbb4fa24f74baeb5,,130489295,2635408,0,0,133124703,2022-10-31
6ae50c3455446cf9,mint,1080530848,17510222,527604,23735,1098592409,2022-10-31
c857d58032f95417,t-mobile,0,0,517876,45206,563082,2022-10-31
c8a932b222bd1f3e,mint,2880803091,113807631,6672,1948,2994619342,2022-10-31
7682a2403b460188,t-mobile,250289278,3269010,0,0,253558288,2022-10-31
01a9210b765b2bbb,t-mobile,3789132172,87172092,8584,3170,3876316018,2022-10-31
b616f64d6f6505d7,at&t,184229,57197,622600,234871,1098897,2022-10-31
847656fcd699c78b,t-mobile,456419,363869,21558,8480,850326,2022-10-31
4c3a519825f8aa52,verizon ,8500172344,180909984,44,15,8681082387,2022-10-31
054dbef2e0ddc706,,152967561,2850156,0,0,0,2022-10-31
69a99a8024eec682,,522659305,6467593,30933915,809254,560870067,2022-10-31
f282b8a2bd74bc91,,153803254,2279370,0,0,0,2022-10-31
fae2ac6f1540a27e,mint,1136749981,51954415,717736,196323,1189618455,2022-10-31
d306cf614738aff9,verizon ,0,0,1100608,214505,1315113,2022-10-31
a95ec5ec4daea5ff,,8106549669,126425343,21006,3903,8232999921,2022-10-31
a310103125618119,cc network,825719,255178,0,0,1080897,2022-10-31
ae01a4cec6053ef0,,152468068,2129539,0,0,0,2022-10-31
4be5851eb2550a63,mint,444506325,27582873,22622,10011,472121831,2022-10-31
165360460b86af80,verizon ,48795126650,769111355,803779,77884,49565119668,2022-10-31
25c4f1cd036ec568,t-mobile,449124,134509,0,0,583633,2022-10-31
0955b946e22a4c87,mint,1060907,220924,14035,4514,1300380,2022-10-31
68931c6efc368077,mint,450696661,10886844,114144,28637,461726286,2022-10-31
d14601feab3658f4,mint,4228464168,102991024,2033867,354430,4333843489,2022-10-31
49d954858fb8591d,,21910,8738,0,0,30648,2022-10-31
188f23ca489dfb14,,957714697,10829328,0,0,968544025,2022-10-31
134efd360e7ff9dd,verizon ,4227898249,123790642,1076787,197882,4352963560,2022-10-31
4057c21f2777a747,,2600252659,50374618,0,0,2650627277,2022-10-31
c4e61e8ec9db3599,mint,858961,326977,205659,68067,1459664,2022-10-31
7ff49d5d6147c10f,mint,55239370,7992506,955706,194754,64382336,2022-10-31
0f360b4def614913,verizon ,8484186167,217050787,35796470,1219057,8738252481,2022-10-31
1fa7ffdd7d7f62ae,,736199,243844,7028,1941,989012,2022-10-31
52a789632d05bba5,,669209,208147,61072,35854,974282,2022-10-31
084289bf74dd52d6,,126212290,3174913,16217,8011,129411431,2022-10-31
f843ff353824e185,t-mobile,611278567,39349393,39266,18178,650685404,2022-10-31
00789abf520120a6,at&t,16553,5551,219657,187174,428935,2022-10-31
5b3258b8d014e94a,t-mobile,926524,337685,8443,2424,1275076,2022-10-31
a46ba3d8ba05729d,mint,370021747,46863298,927623,183721,417996389,2022-10-31
564e76a836734380,mint,314166,105574,13799,3802,437341,2022-10-31
424b0fa3849f9878,mint,82232289,9771091,38145,13250,92054775,2022-10-31
e58a990118f4da8a,mint,119050987,6175954,1320284,75993,126623218,2022-10-31
0d0cad742a0a3aca,,148454059,2041298,0,0,150495357,2022-10-31
2afde9aa8bace730,,155190862,2487238,0,0,157678100,2022-10-31
f20bb5b4b7bbc8c4,t-mobile,1148876171,59771650,1028970,167679,1209844470,2022-10-31
c98155aab7bfcab1,,867740,284668,0,0,1152408,2022-10-31
690de4f71bd6917c,mint,91302,73390,0,0,164692,2022-10-31
066c87a0301992cc,,829782,257418,127800,39913,1254913,2022-10-31
063e3922952f6ab7,,607499,180631,337797,98476,1224403,2022-10-31
c15deb6d4b3d99ee,mint,3606735115,110332273,130888,43984,3717242260,2022-10-31
321079e5793e29d3,mint,664444596,36421588,0,0,700866184,2022-10-31
ae6bc633185ed5c5,verizon ,6704406620,168493621,1841951,859957,6875602149,2022-10-31
fcecadc42916fef5,t-mobile,889584,320898,0,0,1210482,2022-10-31
01cb5c3e937260e8,mint,520830688,44779794,1400249,244474,567255205,2022-10-31
3471791d7d662ab7,home,58150746,1709894,0,0,59860640,2022-10-31
a82d77837b20dc10,mint,704125,130005,0,0,834130,2022-10-31
365c30b8d7274ad9,mint,371814741,29278814,170989,65195,401329739,2022-10-31
e0f6c8cfd5979fc2,,12777,5322,0,0,18099,2022-10-31
fa9bf17db8804212,t-mobile,737730,214736,489878,188255,1630599,2022-10-31
0343beba69487c81,t-mobile,950775,324236,264802,94794,1634607,2022-10-31
45de075f1c32452c,t-mobile,496057956,22785884,40985,14347,518899172,2022-10-31
5307b6869de39362,mint,683288,243240,88604,29204,1044336,2022-10-31
f7e94e6bfe5e8150,mint,763422,211741,0,0,975163,2022-10-31
09f6576f193dccdd,mint,1120509306,83159783,6744,2127,1203677960,2022-10-31
6e365f0a09f02fe4,,220562067,3311137,0,0,223873204,2022-10-31
6da7efd0e02987ea,,156366590,3284203,0,0,159650793,2022-10-31
214d62991c1a31e8,,814823,261117,154412,51466,1281818,2022-10-31
e776794b848baae2,mint,727939,199775,0,0,927714,2022-10-31
7f29b6c0cfa476fb,mint,318604,84985,0,0,403589,2022-10-31
7cc20197f21c958c,,148837731,3001577,0,0,151839308,2022-10-31
398989252a92a115,mint,61024,154265,0,0,215289,2022-10-31
8a1c7995f5243b6a,mint,944435,378648,136948,39177,1499208,2022-10-31
73ee43ee826a4a03,tello,422796979,45723617,638130,31950,469190676,2022-10-31
4c244340a694be2b,mint,717583,224081,135115,48365,1125144,2022-10-31
f35c8a4851f742bf,mint,444230971,10863389,13548,10517,455118425,2022-10-31
69d6148b197f9dac,,142345135,9777444,0,0,152122579,2022-10-31
22ef8649e44d5d47,t-mobile,917888,270330,0,0,1188218,2022-10-31
8728cc96016f002d,t-mobile,60059716,1093247,9600,2743,61165306,2022-10-31
9b9235ef3214204c,mint,598493202,12119950,0,0,610613152,2022-10-31
c1ef82170bd6dfa9,t-mobile,852851561,58918355,209340,64399,912043655,2022-10-31
7f29f29f8d3536f8,mint,3190195973,90146245,746257,65915,3281154390,2022-10-31
41e7eabd88e917cf,mint,785849,265055,39713,12478,1103095,2022-10-31
07bf95819285b747,t-mobile,68338,7038,869035,283888,1228299,2022-10-31
53557cf565d83384,t-mobile,160109604,3314675,48935346,1019650,213379275,2022-10-31
658b9f27db14fb52,mint,251599415,7475027,0,0,259074442,2022-10-31
a276eee7e93c0f7d,t-mobile,69905181,989869,3312,30876,70929238,2022-10-31
af64f9b7366f7b82,t-mobile,312185525,4353625,0,0,316539150,2022-10-31
06aa4e14e1ac5457,,73695663,1711808,0,0,75407471,2022-10-31
975840d17a8671cd,t-mobile,679418674,17209233,0,0,696627907,2022-10-31
aaa062a89b2d4432,mint,968886222,61305192,64368,23916,1030279698,2022-10-31
e342d456a218f846,mint,0,0,866393,272989,1139382,2022-10-31
d1250f17399a3f2b,,443757583,26859261,6744,2199,470625787,2022-10-31
45e59ea190bf8522,mint,51549878,1870242,0,0,53420120,2022-10-31
d96089b5d8bb8d61,smart,1829392595,82721663,0,0,1912114258,2022-10-31
d52fc2a92410301d,,664680,261984,114319,58980,1099963,2022-10-31
36e108fc67063772,mint,916373435,60821679,1793641,294041,979282796,2022-10-31
c9c493f6a009d174,metro by t-mobile,18228,8427,3057,863,30575,2022-10-31
198b9fb85b2e0a07,t-mobile,143989,43701,0,85,187775,2022-10-31
cc2a76561ed0d53a,mint,668767,215284,7433,129024,1020508,2022-10-31
4ab756d7d7418261,mint,2734246973,70224663,16478,2063,2804490177,2022-10-31
ad0342cb39d195a1,,55543254,1064578,0,0,56607832,2022-10-31
4a92a9f9ba80cc39,,884709,262034,675712,239157,2061612,2022-10-31
f0b34771bdef2ba1,ting,688386871,9997391,0,0,698384262,2022-10-31
973051ddc2203c22,,73492498,1308427,0,0,74800925,2022-10-31
769607c41fe6a7aa,red pocket,682681492,46721618,1810834,252811,731466755,2022-10-31
c66404fbfe9fa6ba,mint,290930257,15433037,545221,42502,306951017,2022-10-31
527e4cfe8087f0b6,,769816,218233,0,0,988049,2022-10-31
231126c280b50bad,,73459178,1162445,0,0,74621623,2022-10-31
044b4eb8478301fa,t-mobile,868213,260406,7785,2199,1138603,2022-10-31
3ca6c536e5f7088c,verizon,39712659,1741179,41143,126644,41621625,2022-10-31
94829b0133ee027e,,1008551,231678,0,0,1240229,2022-10-31
362005c0f43c2ee3,mint,418510,751239,0,85,1169834,2022-10-31
c38d666097eec769,mint,720612816,74464763,498,5695,795083772,2022-10-31
c43a0a5cb05e9f6e,mint,386718035,20182506,2288194,339580,409528315,2022-10-31
3a69dce6af5d4727,t-mobile,828221,241792,50238,15037,1135288,2022-10-31
9a43f6b29cb24ee0,verizon ,0,0,1194126,197063,1391189,2022-10-31
6f5662f7b24123a5,verizon ,764437396,42139711,912998,1055224,808545329,2022-10-31
30e09a4c4f4d4199,at&t,12789687,3042795,20328075,175469,36336026,2022-10-31
0c7f20924f564492,mint,689534745,74787950,954490,113084,765390269,2022-10-31
37fd776d8ded34f1,at&t,989342198,73832398,95347,28125,1063298068,2022-10-31
c09a0047ce961ab5,verizon ,613515029,41915586,1913335,256299,657600249,2022-10-31
f0d83d9ef059ac98,at&t,479587743,66084118,616518,9687,546298066,2022-10-31
3593d23acc63f7aa,,771712,235729,0,0,1007441,2022-10-31
a2a3204e78e2fe2d,at&t,24128170,3827699,2326844,1121190,31403903,2022-10-31
1fb95c1562351749,at&t,420782457,46005705,1054722,44838,467887722,2022-10-31
68c7cb383dccad5a,verizon ,289900534,37043656,6802,1848,326952840,2022-10-31
8870d02993d62ab9,verizon ,634849989,62813798,0,0,697663787,2022-10-31
7be97675767a8f9f,,53420936,6768612,0,0,60189548,2022-10-31
dbd998a419b649f2,verizon ,714035265,57850097,6522,1637,771893521,2022-10-31
ff53f74c60959a6f,at&t,881360605,76147141,16095,7433,957531274,2022-10-31
21a2b55ce99d7820,verizon ,1023391155,81166354,38882,13108,1104609499,2022-10-31
e793147ba5f27017,verizon ,1991333650,70784155,122824,41798,2062282427,2022-10-31
1fe7cc62d8dd6dc6,at&t,2760930278,94004819,1080571,197554,2856213222,2022-10-31
26f3a80c277e0949,at&t,30819568123,535424802,6899,1912,31355001736,2022-10-31
36764d1ed30221d3,at&t,4025402116,98049160,373939,127982,4123953197,2022-10-31
df552027ff21b686,verizon ,9750053197,109874151,0,0,9859927348,2022-10-31
d91222cc8d14389a,mint,112575389,13232183,1523994,153380,127484946,2022-10-31
ac990a675df8e962,verizon ,743237,202997,219933,74237,1240404,2022-10-31
6eb63c2126266396,at&t,425203983,60539047,1682865,163518,487589413,2022-10-31
609361c12c9b8868,,147046355,3097870,0,0,150144225,2022-10-31
e8d0d38bebe90ac6,home,348835895,4751443,103258971,2763334,459609643,2022-10-31
eab9ffc84953e49e,mint,432036045,52359664,1957282,251943,486604934,2022-10-31
fcf48265c8524e0d,verizon ,102945556,8734202,60851,19962,111760571,2022-10-31
72027c9a20c1ba3a,,531863518,39578157,84,84,571441843,2022-10-31
376ead77dffa0d4b,mint,1933316801,69408700,109,195,2002725805,2022-10-31
a8881a39e328a22f,mint,501678623,50131428,654816,54136,552519003,2022-10-31
b0830b0a94f948c9,patriot,0,0,0,0,0,2022-10-31
da9de7823c43ba94,mint,290325211,32934941,1275259,255634,324791045,2022-10-31
95bd3c25185fe7c3,,2809366548,110660739,0,0,2920027287,2022-10-31
712754ce98618fdb,t-mobile,1191259951,83173901,79235,29583,1274542670,2022-10-31
2f79efaf9198cae4,t-mobile,19028119634,341382901,657139,37228,19370196902,2022-10-31
5c85d0ba3ef44334,mint,2495191915,55074841,994536,185212,2551446504,2022-10-31
7dc452c45f6c0b15,metro by t-mobile,612713278,62090716,67063,181153,675052210,2022-10-31
a492092aeaff64a7,t-mobile,216364711,19690715,1704678,188585,237948689,2022-10-31
5ffada042c1ee7bf,mint,828075895,43272928,1228047,90966,872667836,2022-10-31
615ed5b079184198,mint,3677332053,86085827,170282,59585,3763647747,2022-10-31
cf54270c60a1013c,,2885880201,181693406,912136,209828,3068695571,2022-10-31
4912b7f7d7c1171b,,820321933,49199592,0,0,869521525,2022-10-31
a24a7ddac01146fb,mint,859179,672939,53226681,833888,55592687,2022-10-31
4f31e9f99259d6da,metro by t-mobile,1325739695,56026576,10857,1728,1381778856,2022-10-31
c95bf931446ffc06,mint,8265419244,201169787,7878544,1659993,8476127568,2022-10-31
3524a91292f7408f,mint,734809193,37163401,1345654,119762,773438010,2022-10-31
be3567de141dd605,mint,3904234604,106391232,1366752,228590,4012221178,2022-10-31
4db864d66da24b40,mint,947845489,24133474,0,2301,971981264,2022-10-31
a47ca697b19706f4,mint,474125293,7933172,0,0,482058465,2022-10-31
d1fa5036ceb84cf4,mint,235304,75713,0,0,311017,2022-10-31
6c27fc48185c61a2,t-mobile,143813734,6546437,568497,78558,151007226,2022-10-31
9a04c7f554762551,metro by t-mobile,975680826,45312656,20710159,917613,1042621254,2022-10-31
1bce8e1442dff77d,mint,756353672,81929301,2027857,354751,840665581,2022-10-31
934a740e87adc0da,mint,839507,152227,21394,7537,1020665,2022-10-31
96c9c3c497760e2e,mint,513162364,59734950,71773,426410,573395497,2022-10-31
4d417196a3d3b2f3,,34872,13982,0,0,48854,2022-10-31
8307626a7b69d6d7,t-mobile,3166832294,76694512,6816,2236,3243535858,2022-10-31
5dc43bafdb876d54,t-mobile,372915315,20251374,1596969,217448,394981106,2022-10-31
d604a9b37da03835,,270303915,12710661,0,0,283014576,2022-10-31
d1bfa634f5aa4aa0,mint,1922797730,46806020,57590,14325,1969675665,2022-10-31
ad04f449ae5828cf,t-mobile,0,0,877101,167378,1044479,2022-10-31
3f3e47b3eaa6a54a,mint,1208800451,25620419,2100291,349064,1236870225,2022-10-31
a491a97ad7d9e746,mint,643801450,55662896,609968,150207,700224521,2022-10-31
bac4341e92eee369,mint,442514010,61629988,7248,3589,504154835,2022-10-31
9de11eafe67ee951,mint,428623350,27296965,13603,18206,455952124,2022-10-31
1b390a1008dabc02,t-mobile,250140702,4527275,104,104,254668185,2022-10-31
0358578beb113a4d,mint,622271244,13701822,13789,98746,636085601,2022-10-31
ad8b9eec060c529d,mint,928926376,41086767,5524022,390180,975927345,2022-10-31
80a2d4e2f7d1866b,mint,693919918,71052088,990487,164814,766127307,2022-10-31
9c588bc23909ba23,t-mobile,5275582140,86636497,49873,21224,5362289734,2022-10-31
66f93fc45dfda25a,mint,43332,18016,127676,40995,230019,2022-10-31
1e303392fb2cebed,mint,0,0,59604419,1330788,60935207,2022-10-31
574abd6ddb5c3982,,131705636,2777087,0,0,134482723,2022-10-31
4ea07152cfed71f3,metro by t-mobile,487625270,66591662,704893,58891,554980716,2022-10-31
e9a290fd4bbe94eb,verizon ,1382003406,109077738,132527,48275,1491261946,2022-10-31
3fd5e45686436200,t-mobile,476159225,43641570,1613854,237527,521652176,2022-10-31
da5052cdbb7d077a,verizon ,0,0,35384,17238,52622,2022-10-31
90ca8169b5ae76c0,verizon ,114697006,19265394,1310902,88792,135362094,2022-10-31
ff120383159e981c,at&t,456077993,61095378,209730,68615,517451716,2022-10-31
d213284d5f3a1d51,at&t,831756017,68916176,6465,1701,900680359,2022-10-31
a7800cd607996f68,spectrum,278386108,11313151,1022788,151362,290873409,2022-10-31
e26a7ddebd865823,at&t,905731890,66593239,13339,4154,972342622,2022-10-31
664eead97a224238,at&t,502836320,55793562,788935,72575,559491392,2022-10-31
cb67132311cd37e9,at&t,632374906,52395892,646427,55722,685472947,2022-10-31
2a3677ca49a2f2e8,mint,1130983518,38636081,1292513,51380,1170963492,2022-10-31
c29738625b9e0d0d,,1113248766,62685163,6468,1743,1175942140,2022-10-31
d563502cb6d030dd,,818260345,66486316,32059,17700,884796420,2022-10-31
4786fbf82e54accd,verizon ,933677315,87820068,810712,65030,1022373125,2022-10-31
48f398ac3a804db3,t-mobile,702165034,16130200,1309712,63542,719668488,2022-10-31
b721280f547deb57,verizon ,4341194105,37632057,862280,63545,4379751987,2022-10-31
3375f5324e57227e,verizon ,146970248,26347527,26453,9650,173353878,2022-10-31
1fc0dadcbddcc185,t-mobile,116163241,7978361,727,2805,124145134,2022-10-31
2c3297a16a80ad47,,39117157,1672907,25407,52086,40867557,2022-10-31
db021eeceea1958b,mint,152920800,2866660,216934,49444,156053838,2022-10-31
ee0392370841ae61,,176327330,4442368,0,0,180769698,2022-10-31
19be9125b69459e9,mint,1111156,239772,0,0,1350928,2022-10-31
2c4a343376f9e3b8,mint,808422,233282,198346,60293,1300343,2022-10-31
f7848e5134b2a4d8,at&t,3050752328,101023594,1334332,64533,3153174787,2022-10-31
b2341be523b66b8c,xfinity mobile,33218969,5629570,0,0,38848539,2022-10-31
4ccbf2e6126b6bd2,verizon ,676792204,73464698,630393,20356,750907651,2022-10-31
459c953a0bbb7c88,,185557194,25255126,0,0,210812320,2022-10-31
4f50c9a71311d3d8,verizon ,735387859,90041661,111896,42096,825583512,2022-10-31
3912d491fa53f369,verizon ,0,0,1937788,268085,2205873,2022-10-31
75194b149b38ed53,verizon ,2128243474,36248986,6661,1637,2164500758,2022-10-31
16ada6360758ff62,t-mobile,512289854,58819658,1332772,314914,572757198,2022-10-31
8ff6dc975fe91c8b,verizon ,591897303,56902670,748510,62267,649610750,2022-10-31
4b2207bc5f860767,verizon ,252381102,24460714,263333132,1844219,542019167,2022-10-31
c0af7976dc88765c,,230218236,16381330,0,0,246599566,2022-10-31
ac4dd77e129fc56e,verizon ,641786252,44955227,84,84,686741647,2022-10-31
a334912eaaaedde9,at&t,173297982,18723915,1310051,113535,193445483,2022-10-31
d64696bdfcf3fbe2,cricket,816338,247212,516902,147494,1727946,2022-10-31
f28b44d85340ed33,at&t,602424721,17217207,1333890,122518,621098336,2022-10-31
4e9d11721e62cbd8,at&t,1667366144,78677431,0,0,1746043575,2022-10-31
331d4a545ff8a816,verizon ,945333217,68378951,777844,69037,1014559049,2022-10-31
ca961986eccaf5f3,at&t,43863030,4280921,1882800,285444,50312195,2022-10-31
c01daaccf7c17532,verizon ,507534602,33733120,416,170,541268308,2022-10-31
413daa2aeeeda1d0,,147871793,1734613,0,0,149606406,2022-10-31
b9a3282b6e991c54,verizon ,457876781,35959136,812663,217040,494865620,2022-10-31
492b179c5de1f755,verizon ,355390622,36342140,796952,43015,392572729,2022-10-31
02e86c7594632af1,mint,1604556517,42448099,33341,15676,1647053633,2022-10-31
f4ee4bf119763ca2,xfinity mobile,744582646,72607156,0,170,817189972,2022-10-31
7a9b990d646961b5,verizon ,426441019,9091396,3333693,250955,439117063,2022-10-31
ac709812bb8dcc8a,verizon ,727742832,83382045,19705,5172,811149754,2022-10-31
24a1d207b1a53f25,verizon ,347207812,10168590,78754268,742776,436873446,2022-10-31
cdea0cb1518383fe,cricket,0,0,30621,6787,37408,2022-10-31
30b6f51fd47339b2,t-mobile,1016273013,59676461,305142,118572,1076373188,2022-10-31
ee3abceb35d1e741,mint,714036989,20731713,0,0,734768702,2022-10-31
3a421f0e50ecc8ff,mint,340757980,41969478,1446135,169922,384343515,2022-10-31
abbe225c1fa00ac8,mint,2187071580,46292708,2054729,327828,2235746845,2022-10-31
9bf92d9f39a6704d,,613678842,52482504,6935,2284,666170565,2022-10-31
f41f3b90d5a768ee,t-mobile,237432887,1029929,1539419,274297,240276532,2022-10-31
ec5bc9f9d47f02d9,,458290327,16274070,0,0,474564397,2022-10-31
2f9564ea22898451,mint,0,0,40492,8753,49245,2022-10-31
e3d2d308cfd1877f,mint,2261325671,84393695,120157,43915,2345883438,2022-10-31
1f090e4f04c22d4f,t-mobile,1162670907,78526580,1311439,82715,1242591641,2022-10-31
68694d5c4196d89a,mint,811727049,86846285,6768,2575,898582677,2022-10-31
f0ee0d08c6d39e67,mint,950330116,37916913,823485,104328,989174842,2022-10-31
cfd46edfe792744a,t-mobile,1170133471,95964196,6468,1899,1266106034,2022-10-31
80524bcff6b9c253,,114775854,3493830,0,0,118269684,2022-10-31
2e7546a0e47c716b,t-mobile,512449639,43062111,508248,150719,556170717,2022-10-31
00e3bb1f3e08a39e,mint,846933812,54942898,20409,6323,901903442,2022-10-31
c46caad20a2a5b9b,t-mobile,1087467128,28715544,839344,104642,1117126658,2022-10-31
a397f13aed7a1db6,t-mobile,51014249,5142820,650667,40904,56848640,2022-10-31
b9b653609bcbc0fd,mint,845559016,61251794,0,0,906810810,2022-10-31
814215cba14e8f54,mint,1655895497,74079275,20554,6529,1730001855,2022-10-31
ad0b8c6d9f279d4c,,145848661,1851360,0,0,147700021,2022-10-31
70a9b1c1ca279f24,,189462956,2686682,0,0,192149638,2022-10-31
b47844f963afaa25,t-mobile,1143776216,70614714,69792,23965,1214484687,2022-10-31
93883c48abfb27f5,at&t,815136,250636,675797,213237,1954806,2022-10-31
f791dcc0484f22bb,mint,32280181,6033705,85831,31413,38431130,2022-10-31
16a1ec7a20797921,,146121308,22062955,119993,42944,168347200,2022-10-31
ae81e06b99fe9451,flash,3602068654,93996724,221263,79231,3696365872,2022-10-31
51998e00fecc2935,t-mobile,810090719,9127822,126174305,4281556,949674402,2022-10-31
fc99ba31ed563989,,5000474359,81850945,9315,4266,5082338885,2022-10-31
12feb43ca3b1db7a,mint,720945806,66650602,1472982,341752,789411142,2022-10-31
f0cd40f75ff49a63,mint,2742483457,47384901,43872,14896,2789927126,2022-10-31
9267ed61def80ab6,red pocket,357268770,7276358,335903,110882,364991913,2022-10-31
ce91a0c6be9ff65d,t-mobile,54177055,1398483,91574,32375,55699487,2022-10-31
429a39301b61d6d3,mint,587690205,45753577,210075,78231,633732088,2022-10-31
7d96f050da655d07,t-mobile,334221203,5029155,21514,7707,339279579,2022-10-31
aa11ed6ec7dead59,,873164269,28238307,24746,5663,901432985,2022-10-31
e77e8c0304629224,mint,1546050632,74043939,139051,44361,1620277983,2022-10-31
1804c3a70dac7a27,t-mobile,331380482,55169469,246732,109616,386906299,2022-10-31
a44e542a4ae5861e,mint,40401,5845,0,0,46246,2022-10-31
1d10db3c081f86fb,t-mobile,2883148495,91727758,274221,103091,2975253565,2022-10-31
4e88ea724b776363,t-mobile,637958,188183,0,0,826141,2022-10-31
b1bba7b72ec203f8,t-mobile,411219435,23137514,7254,3056,434367259,2022-10-31
c43edb1c730d203f,mint,214629630,2316222,306046,302074,217553972,2022-10-31
5669a0677efbbb8f,,139435841,10424449,86106,29037,149975433,2022-10-31
0a0eb6570d08a7a3,t-mobile,521691328,23962281,673073,173428,546500110,2022-10-31
b523fcb7cb6b8936,mint,62268570,5694996,0,0,67963566,2022-10-31
ca3108098c688147,mint,0,0,1240570,131449,1372019,2022-10-31
9e9cb48b19e6bce6,mint,467019823,58533799,660570,142015,526356207,2022-10-31
ab0e08b1f080f2f2,emergency calls only,457618,54756,0,0,512374,2022-10-31
6c686981fc1ae2d3,mint,522029610,39490942,246633,85864,561853049,2022-10-31
a72ddebec6d2293e,xfinity mobile,322473709,23527974,203579,68259,346273521,2022-10-31
811c6d17c27764fe,mint,1597880576,68106683,13043,2604,1666002906,2022-10-31
4401e7fe0a58228c,,48341660,8232945,0,0,56574605,2022-10-31
debd20ea6063e047,,426787442,35465776,331912,51208,462636338,2022-10-31
5a1bc801c685fe13,at&t,1858564475,53024944,68638,18686,1911676743,2022-10-31
a790969f240e71a4,verizon ,739077049,77694053,289662,96053,817156817,2022-10-31
e891010ff64300c2,mint,793413887,47704233,628956,26089,841773165,2022-10-31
86680f1335be9e6b,mint,616744257,59775689,1117522,202087,677839555,2022-10-31
d6c35370923484e4,verizon ,306401636,30489517,697812,272981,337861946,2022-10-31
40b41b180c6dd1b5,,455661028,32006722,10930,9675,487688355,2022-10-31
fbad8675aa05f051,at&t,743322355,28163025,277446,29165,771791991,2022-10-31
4bacc18f1577afb1,verizon ,805139910,78079409,45819,18172,883283310,2022-10-31
8569f28129337f9f,t-mobile,397100160,30177421,631786,22851,427932218,2022-10-31
bfe7a457fbfbaa5f,,31116787,1247812,841963,237251,33443813,2022-10-31
0c3e22391192060d,verizon ,655350735,46276642,706120,43195,702376692,2022-10-31
ab391072c2ab98e1,home,136777479,1419033,47683,12440,138256635,2022-10-31
49514b6beb31bfec,t-mobile,811098217,62297804,48972,23271,873468264,2022-10-31
8efbf58a21cadaaf,mint,45719,36635,416946,158741,658041,2022-10-31
f7fcb051f4fd64b7,mint,771338,306687,9188,2352,1089565,2022-10-31
ee9ec9afa40fb138,mint,888607,229885,145476,51245,1315213,2022-10-31
fe087f725f497036,mint,747765,229432,0,0,977197,2022-10-31
4a2525ba3bc4c79e,mint,434716865,55989106,1592083,172290,492470344,2022-10-31
81d969ebb5184ae6,mint,921620,279796,381900,373784,1957100,2022-10-31
59f676d572cea6c5,mint,394794374,6698936,185786,350287,402029383,2022-10-31
5046396bcbab8fa2,t-mobile,121012,36041,0,0,157053,2022-10-31
19cb00141528ffd0,,616791089,34631228,430289,26077,651878683,2022-10-31
8302db4011616e34,,66100253,1262672,0,0,67362925,2022-10-31
e1c8b5c4e4830024,t-mobile,270747694,20625041,14,5,291372754,2022-10-31
6d75051fc315960b,,73554286,1124589,0,0,74678875,2022-10-31
16119febd21f083f,,145551727,21593369,419298,99978,167664372,2022-10-31
4c28ffb102ce9221,,101137,158452,384124,233855,877568,2022-10-31
75944515691e3717,mint,4028827248,120856217,69280,32478,4149785223,2022-10-31
c267060d61a744a2,,148444971,2539676,0,0,150984647,2022-10-31
29391652ee280f08,mint,874968608,44176862,38485,10826,919194781,2022-10-31
a7b17e2d7edaa4fc,mint,4032902131,133692827,13728,4389,4166613075,2022-10-31
cc1b4e771ca2a870,t-mobile,782497156,66468177,2293565,371122,851630020,2022-10-31
6513f807248a1b9b,mint,106882994,7415303,47699,11761,114357757,2022-10-31
1e87a13b110d37a0,,24543,8638,12122478,462266,12617925,2022-10-31
632df1e7541c81b6,mint,1118838340,73534444,0,0,1192372784,2022-10-31
4d45bf67db8bbe2c,,31289,7352,0,0,38641,2022-10-31
5370359839ded606,mint,2031006,329752,1291864,71581,3724203,2022-10-31
fe0695d8cffe3769,mint,663276917,58368058,505858,220270,722371103,2022-10-31
0b6c257cfa5ef97d,t-mobile,1032247524,64430725,38869,9126,1096726244,2022-10-31
4e73f87870ee0ea4,mint,10749349150,202073695,710232,61753,10952194830,2022-10-31
06d72aab972e1031,verizon ,782531529,76695476,132580,63289,859422874,2022-10-31
d60c32963628ac75,verizon ,3543040567,88787138,1384137,229022,3633440864,2022-10-31
4774695200675028,mint,891288240,21516854,1512578,407632,914725304,2022-10-31
ded4d72094aed58e,verizon ,892858276,56003387,947015,48291,949856969,2022-10-31
bb7084386dfa2918,verizon ,377043346,5192643,124136,39895,382400020,2022-10-31
321141048af913a5,at&t,519279545,54581486,21755,8254,573891040,2022-10-31
fc0a9a667ceecb71,verizon ,0,0,33699,8107,41806,2022-10-31
9998f87efb184e49,verizon ,905727754,31424063,84,84,937151985,2022-10-31
6e35510b7677d70b,mint,22533,4148,224090,71924,322695,2022-10-31
3bdeb4ae5ff93e8b,mint,157710,29196,20763,6866,214535,2022-10-31
c9447bd74a15674b,mint,543081273,42728527,1104884,178091,587092775,2022-10-31
b37896fb77e67351,,404230880,39803642,202811,81299,444318632,2022-10-31
52f626ea0778ef37,t-mobile,661135944,49728362,33627098,803929,745295333,2022-10-31
ad96bb5c8dec9423,t-mobile,1094912516,38369848,7044,2284,1133291692,2022-10-31
460784128aa60b82,,505797,237658,111911,34416,889782,2022-10-31
80aef9a7b94c36e5,t-mobile,3487401155,50023332,0,0,3537424487,2022-10-31
c9e98c49ecad282b,,76245240,2165134,0,0,78410374,2022-10-31
022d67488638d379,mint,674815055,14653582,0,0,689468637,2022-10-31
442cc16a89af5891,mint,1041968112,17021891,75380,23380,1059088763,2022-10-31
55bfbac8627ddb8b,mint,5312035,416062,48122,12277,5788496,2022-10-31
c37f58e1c6df2daa,mint,0,0,799732,280408,1080140,2022-10-31
8083ae62979d3e33,mint,772952,234780,24118,7798,1039648,2022-10-31
d865262df0dabbef,mint,328209723,44420798,58337,20640,372709498,2022-10-31
9de692698adf632e,at&t,943481308,53451374,20914,5785,996959381,2022-10-31
e8f1276557156ae3,,112374221,1749237,0,0,114123458,2022-10-31
ccdc55e77b93f79c,mint,297855934,15495527,0,0,313351461,2022-10-31
207975a4e43caa76,,92559582,1258541,0,0,93818123,2022-10-31
4d57299610265f60,verizon ,496125182,77268570,1069492,154431,574617675,2022-10-31
edaf642be18ec077,,542969783,42534651,1479209,140541,587124184,2022-10-31
20d726ce7ffad230,mint,488001,349287,0,0,837288,2022-10-31
28f40006ec6ddf08,at&t,1038796333,74625582,20521115,432162,1134375192,2022-10-31
596a14c5cc834356,verizon ,790448779,82420272,70198,20973,872960222,2022-10-31
125e9681861a25f4,verizon ,800848490,59163017,2114138,593359,862719004,2022-10-31
6249e498c3ba3b8c,verizon ,2960989685,79062621,1408411,153561,3041614278,2022-10-31
bc053f136a9b5c44,verizon ,436169065,26847665,943663,152288,464112681,2022-10-31
02aa4204ea78d53c,cricket,519789495,32760959,847542,117201,553515197,2022-10-31
f4503ff6447750c8,verizon ,596677454,52408968,6661,1741,649094824,2022-10-31
8015973e16b6bebc,t-mobile,1149182665,61092447,1757800,623125,1212656037,2022-10-31
2acd51b79b263c52,mint,498009849,60165381,156015,65605,558396850,2022-10-31
405ef4e5acaeee0e,verizon ,6246723115,157719147,857851,117004,6405417117,2022-10-31
35fab244df1b6209,telus,624008920,36912790,2052963,314102,663288775,2022-10-31
ff55e50067cfc9ff,mint,303177970,26743415,11673,204514,330137572,2022-10-31
27cd6c423cf0d177,at&t,685477155,64152078,913455,134413,750677101,2022-10-31
74a7c14ece32ac83,verizon ,265936345,13486849,1533049,326833,281283076,2022-10-31
965ebea3845b5bb2,verizon ,728159,201852,516347,179944,1626302,2022-10-31
fbdfb3212bea2097,us  mobile,250941085,26357113,686824,78634,278063656,2022-10-31
25a30ec44d3192f3,at&t,633256923,51481741,1276387,44233,686059284,2022-10-31
06b23b1d4e9b6061,mint,1232335594,84255165,1369717,262414,1318222890,2022-10-31
c0e8ebb5551a060f,verizon ,711572854,62658025,2038978,301106,776570963,2022-10-31
3915e96485711125,verizon ,741868278,12058296,2500441,508964,756935979,2022-10-31
beb2b44268046d92,verizon ,31631,6878,84,84,38677,2022-10-31
f866f1adfa91f0d2,verizon ,3594287242,91319748,6742,1279,3685615011,2022-10-31
0a15ca56592cc135,verizon ,90380025,12849155,1307047,76465,104612692,2022-10-31
a9cbdaf3ff44048c,at&t,783642924,76041339,1063534,264420,861012217,2022-10-31
f7891df2ba625f25,verizon ,1205986330,61612216,1287949,69232,1268955727,2022-10-31
0d153dc7ffe5bfd5,verizon ,623880385,68271170,741793,59416,692952764,2022-10-31
059db337fbec80d3,,12103033,146785,0,0,12249818,2022-10-31
9eadf081ffbccc61,metro by t-mobile,448314367,89294982,7044,2284,537618677,2022-10-31
3d127d738b195a71,mint,0,0,1199189,95708,1294897,2022-10-31
c5a0b489bd4f5cb7,,183230609,3475582,0,0,186706191,2022-10-31
27ae0db4a30a000a,mint,794660867,64690093,385563,6415,859742938,2022-10-31
1d74eb8f3a6de3ce,mint,378122590,17685290,0,0,395807880,2022-10-31
0d9c0d60fffa073d,t-mobile,25673,52585,0,0,78258,2022-10-31
22c40c530c71e6e5,,160999,269517,0,0,430516,2022-10-31
27995522164a86dc,t-mobile,54417899,2766946,482044,368269,58035158,2022-10-31
dce5d7916e6c6375,mint,1006272314,31696688,879685,126382,1038975069,2022-10-31
c16e4fa3f6b847da,mint,551735430,65402403,1958,2139,617141930,2022-10-31
33b5208b382aa7cf,mint,185225,136116,63362,19152,403855,2022-10-31
73916b4655a68fef,mint,776472159,39631869,1420634,271414,817796076,2022-10-31
cb9a8b37338223bc,mint,561653,187648,295818,23044,1068163,2022-10-31
f1e0ed6503b06f96,mint,374837028,17080853,0,0,391917881,2022-10-31
1e26ad7f0266d070,mint,587967261,16536015,1331352,76526,605911154,2022-10-31
f8aed8083e4b3b9f,t-mobile,2815831,136742,124603314,6985303,134541190,2022-10-31
525af3c8fd365c9e,t-mobile,477914835,79940819,0,170,557855824,2022-10-31
c977f92a777f36a1,mint,255169737,4451462,0,0,259621199,2022-10-31
c5345a31bf671138,mint,827358593,40458838,1529502,266728,869613661,2022-10-31
e389fdfae03e186b,,759456,215819,0,0,975275,2022-10-31
32d7b2f7b62efa67,tello,3409047563,90997637,3025865,605752,3503676817,2022-10-31
2095fe7c1f6ad4d5,mint,814243,351752,218992,57571,1442558,2022-10-31
d72a82fdbeac2b21,mint,0,0,577764,185161,762925,2022-10-31
0b7fcf4b06598b7e,,25645983,3980969,0,0,29626952,2022-10-31
d48c0152e5c612f0,mint,5331559137,95995463,30327,10058,5427594985,2022-10-31
439f2f7e762e6bf5,mint,77348655553,1037513304,14204,2699,78386185760,2022-10-31
6dcd076f94634a9d,mint,1998013733,38629709,6684,1844,2036651970,2022-10-31
afacde5540a76395,mint,0,0,1256063,94256,1350319,2022-10-31
ca40e8743055509a,mint,1344109053,84956483,0,0,1429065536,2022-10-31
7162ef4b95ef750d,mint,5210618513,146232962,30609,5803,5356887887,2022-10-31
2c8c55e738ed60ee,mint,0,0,1286845,321810,1608655,2022-10-31
e86b044193033f57,mint,1211598024,64939863,398180,75692,1277011759,2022-10-31
2c77f61ef747a3f2,mint,451604618,19650976,44063,16324,471315981,2022-10-31
8a9a9c58a433af3b,mint,2872151790,99662132,130164,1074640,2973018726,2022-10-31
12c3d9206e4c02f1,mint,1010017604,64115339,1241070,271293,1075645306,2022-10-31
b3611520528bf200,mint,798782833,78869376,522,274,877653005,2022-10-31
2598e03141e48c9f,mint,2294602003,68225688,6935,2356,2362836982,2022-10-31
6cde994d56e6c5e9,at&t,1179993500,96044102,640,4884,1276043126,2022-10-31
220a59c7cdbb8276,,57964692,948451,0,0,58913143,2022-10-31
8f33ff5796eb8b0b,mint,552601042,50745946,74312,26547,603447847,2022-10-31
4d9834ac5349be01,mint,631655083,49541052,178586,71477,681446198,2022-10-31
1e791a5dc307ac5b,,91787457,1978635,0,0,93766092,2022-10-31
66d4f2e988e5def6,,702061095,6342961,0,0,708404056,2022-10-31
a848139826dffdfa,at&t,899232328,62023225,637734,26073,961919360,2022-10-31
873197b59edd6dc1,,2803045,532201,0,0,3335246,2022-10-31
4577a67c8a648b71,verizon ,5811668368,101970863,127723,42590,5913809544,2022-10-31
4adec0b21a4afc49,,1715560,377131,0,0,2092691,2022-10-31
7338b114436cc368,t-mobile,783284023,76957193,475661,9917,860726794,2022-10-31
b0c08c7febfa5f96,verizon ,400095356,27134889,88681,26000,427344926,2022-10-31
483ecb75e73dcfbc,verizon ,466934222,63555515,911111,118480,531519328,2022-10-31
dfec1372a4f94d9a,t-mobile,113262,150522,305547,700030,1269361,2022-10-31
38502d9bcfbfb954,mint,495818028,10143149,0,0,505961177,2022-10-31
b722b20896e372d7,t-mobile,1494232606,31646581,154613,62136,1526095936,2022-10-31
911a6677b2baf879,t-mobile,0,0,54329726,1449895,55779621,2022-10-31
4eda1214d09cc2ca,mint,1657604536,75449373,1031695,180665,1734266269,2022-10-31
056cfc9cd78f8c38,t-mobile,737042,318657,159024,55282,1270005,2022-10-31
68f8a83b4ac5f0f2,mint,203300758,12325148,22479,4645,215653030,2022-10-31
90508e21737ddb27,mint,911525,159365,521863,164589,1757342,2022-10-31
a9bcbedd34f7b8e5,t-mobile,458456863,43648278,253849,99532,502458522,2022-10-31
cb6af862f5f4de2a,,18746709,430407,0,0,19177116,2022-10-31
dba293b22ea4cb33,mint,0,0,633657,55210,688867,2022-10-31
fb0731b345ceaf7d,mint,0,84,29785,10764,40633,2022-10-31
f0d8319ff9823580,mint,560597595,62833870,444809,151790,624028064,2022-10-31
e481bd061b632554,mint,349554013,39975582,1706765,305829,391542189,2022-10-31
c4cb112168de987a,mint,763739,282798,232435,65825,1344797,2022-10-31
9c0260d1b67aa52c,mint,67316499,14780012,2927010,848564,85872085,2022-10-31
5f1e805ecbcf1f89,mint,868691233,56163342,90114,33160,924977849,2022-10-31
d2a3d23952513445,mint,283205,178281,807801,271575,1540862,2022-10-31
23c1d825359af82e,mint,147366594,2358428,0,0,149725022,2022-10-31
0380b653ad576b34,verizon wireless,1516801763,89539701,153234,59977,1606554675,2022-10-31
0c8e20e46717464d,t-mobile,439991,146230,998810,336487,1921518,2022-10-31
a0767cf5a5d836cf,at&t,447011417,6680476,1325648,56897,455074438,2022-10-31
b0420c81d9466bdf,at&t,886519607,54254397,1855679,546800,943176483,2022-10-31
b585db91de5418bc,verizon ,138047,867359,837592,260304,2103302,2022-10-31
9d8c64e405e6ff36,verizon ,758237313,20483303,1660442,232086,780613144,2022-10-31
64cada00d82d686c,at&t,546727993,30202389,1198911,231454,578360747,2022-10-31
5d511231d0b31a57,verizon ,459388605,50680194,1382363,289032,511740194,2022-10-31
4ae650badc3cd4cf,metro by t-mobile,1094551479,27153342,1117780,220326,1123042927,2022-10-31
638a6a9bef5f3aa1,cc network,1268003201,70776057,648628,46307,1339474193,2022-10-31
12e9da668fc2bf13,t-mobile,757006052,30983709,1299346,269917,789559024,2022-10-31
bcaf57e973acf663,at&t,0,0,481645,41113,522758,2022-10-31
bb88d605ea50e6f2,t-mobile,1904934165,62018215,107480,1118661,1968178521,2022-10-31
6c82946b7e2c822d,verizon ,804021879,78229801,0,0,882251680,2022-10-31
3eda47c96dcc81b9,at&t,4224861793,122845430,0,0,4347707223,2022-10-31
813cc9d85f37409d,verizon ,653808023,49731143,21238,6343,703566747,2022-10-31
e7bacd96d3abdb9d,t-mobile,1109832274,54248283,1440929,110498,1165631984,2022-10-31
f471454a5a0cdf31,t-mobile,675611828,78512185,14969,4294,754143276,2022-10-31
2b028708525e5c5b,verizon ,741445966,10669531,1567556,419282,754102335,2022-10-31
03efaed078d9791a,t-mobile,975433298,14956531,660935,308016,991358780,2022-10-31
2d11850ab4517a74,t-mobile,3192389594,31442399,1318108,74671,3225224772,2022-10-31
782186bdb8ad1dce,at&t,782561545,58977570,1879330,321975,843740420,2022-10-31
8515d0fb3f5e186d,mint,626143968,58191977,141441,48263,684525649,2022-10-31
ad849cc0f1820b81,at&t,0,0,30015,7462,37477,2022-10-31
8e2f61f1f230792c,verizon ,661462548,57110116,12956,3292,718588912,2022-10-31
95a75b7ccd74e0a1,cricket,0,0,35881,281689,317570,2022-10-31
a376f656b148c0ae,verizon ,583662866,58482837,64056,28503,642238262,2022-10-31
9b9d6e3eea3b3d6a,t-mobile,813096842,46679692,4283,2307,859783124,2022-10-31
7dada595db45f0ec,verizon ,782370319,67066172,595698,33863,850066052,2022-10-31
cea2cca811237851,rogers wireless,612962166,45372760,8715,2515,658346156,2022-10-31
9096ff1ab1959dd6,,901852,268366,762219,217282,2149719,2022-10-31
8e83b0bb974dfda9,mint,42883007,4549238,755619,78390,48266254,2022-10-31
26c77d5edea7c8e8,mint,12500900,383444,754105,344342,13982791,2022-10-31
47e19c16e69bcc67,verizon ,1024576822,71569710,166340,55874,1096368746,2022-10-31
9c4adaba206cfee2,mint,28560847918,373485806,103990044,2623753,29040947521,2022-10-31
049fff20cd51df03,t-mobile,937506848,17293931,791435,159227,955751441,2022-10-31
f157329e7e0ef62a,,707464,188208,0,0,895672,2022-10-31
e5226d75bb71dd39,t-mobile,645404532,55989028,15333,5986,701414879,2022-10-31
37a21fa797e324bc,mint,5667,18574,413464,226076,663781,2022-10-31
8bcf773524d4082b,t-mobile,3810583979,79773704,1123215,198828,3891679726,2022-10-31
d68adc795ad3314d,mint,856497573,70087204,21887,9377,926616041,2022-10-31
9e5c026c0ac2d986,mint,363895558,4917536,40175591,2194340,411183025,2022-10-31
0372571f3613c654,t-mobile,53562251,1413744,20255,4174,55000424,2022-10-31
739dd00efc79d303,t-mobile,93493414,13533829,176949,60559,107264751,2022-10-31
7c653c9578845e42,,128855522,2514272,0,0,131369794,2022-10-31
bb4044fb44a13d0b,,194516111,7833195,0,0,202349306,2022-10-31
f8670a07e70b8927,mint,353609352,33594654,1953271,399875,389557152,2022-10-31
9f955691f158dbd2,mint,192590142,3020131,0,0,195610273,2022-10-31
98d1aa42d44f15d0,mint,171779,293053,387922,130983,983737,2022-10-31
09c0271d25e951aa,verizon ,407071440,15901326,1968655,272725,425214146,2022-10-31
32cb056984870fc4,verizon ,712218455,63544337,26368,7387,775796547,2022-10-31
d20f376d0297df3a,mint,709255830,84825412,88405,37520,794207167,2022-10-31
361cd0999aa37153,verizon ,1291376984,51979973,2059618,290600,1345707175,2022-10-31
68a3342fc871cd42,t-mobile,783069436,65747512,44960,13733,848875641,2022-10-31
4f97018ffc46a6a9,verizon ,410201730,40903971,772254,57239,451935194,2022-10-31
74de6a9407ae7688,at&t,763815771,7445958,18323,3820,771283872,2022-10-31
1091b0e4d761aafe,verizon ,333983543,78428576,65264,20170,412497553,2022-10-31
ecf1bb1d049fc2d0,verizon ,3782428048,81315625,175046,66273,3863984992,2022-10-31
f35028f056d16a3b,t-mobile,659697023,74928658,2049949,437156,737112786,2022-10-31
529aa0479c7eeb0f,at&t,252256216,5493755,804975,137264,258692210,2022-10-31
984fe5e70f83a40e,cricket,1185099238,80822043,156701,60542,1266138524,2022-10-31
9494cddb268598db,verizon ,939698568,53000335,1997527,289001,994985431,2022-10-31
ecd082c853bfcb72,,3529704546,126975606,962461,159547,3657802160,2022-10-31
4e0007e81c65a53d,,691324,187405,0,0,878729,2022-10-31
87892c3de8f1f2dd,verizon ,817613561,72722301,739185,56775,891131822,2022-10-31
a07349b51377918d,mint,1053667559,18112283,1964959,500764,1074245565,2022-10-31
e661846ed8b7bc4a,verizon ,735965027,52752751,884083,95131,789696992,2022-10-31
e6f24fd9064f4c42,verizon ,1234237536,63206462,34402,10316,1297488716,2022-10-31
7e50f2b5054bd525,verizon ,35606553,7449174,44787,263714,43364228,2022-10-31
de3dc748cd743087,verizon ,486396901,69395047,347083,111312,556250343,2022-10-31
0fd47037b8c7cb3f,at&t,1323359132,9836911,123,142,1333196308,2022-10-31
bc6c66624b1772dc,at&t,846008608,93133785,0,0,939142393,2022-10-31
b2aa21b14bf19e0d,mint,956881318,87084030,658897,32591,1044656836,2022-10-31
4013eec026f72a65,mint,945885379,61941263,1894049,226671,1009947362,2022-10-31
3ea0ac8d3282114f,verizon ,888582420,54680274,284387,90000,943637081,2022-10-31
4b09b2652c7e4a8e,verizon ,78146027,1951136,0,0,80097163,2022-10-31
26cb8b22375ac0f8,mint,519406490,46682038,1698693,190604,567977825,2022-10-31
6179ea1aa6031e9c,mint,1164788401,74028456,19955,5230,1238842042,2022-10-31
44b35412a473b021,mint,2249977077,95719714,371352,145738,2346213881,2022-10-31
958c30fa8b386611,,1321737705,14349729,487554,803358,1337378346,2022-10-31
f3b55c0ee62ae146,,97141445,2106610,0,0,99248055,2022-10-31
b49c701bb48ac4fa,mint,683097148,54240851,0,0,737337999,2022-10-31
e8d7f1596661f90a,,385413366,6521684,0,0,391935050,2022-10-31
258d808545a5d3be,mint,5899517354,105542362,690716,101261,6005851693,2022-10-31
38b9e321ed45e9a7,,93093457,1021921,0,0,94115378,2022-10-31
6d7cdba1142fdf14,t-mobile,0,0,1514550,270550,1785100,2022-10-31
c398b4658b41ca68,mint,0,0,0,0,0,2022-10-31
46bf590490a37e36,mint,0,0,20439,11676,32115,2022-10-31
bb2a7fce05597602,mint,92449578,15491184,0,0,107940762,2022-10-31
42d8fb6fb4468251,mint,707670492,57764907,7044,2356,765444799,2022-10-31
299d9514d3b5607c,mint,325945088,7608160,655087,50603,334258938,2022-10-31
520e268a2ebb2cab,t-mobile,562993490,20182566,319181,100007,583595244,2022-10-31
915f7ae21356c1bf,mint,55544524,564839,18380363,1474959,75964685,2022-10-31
3b33e7e9980e26fc,mint,21490547,929802,0,0,22420349,2022-10-31
6af0c3ed040a70b0,t-mobile,370953037,40131605,0,41,411084683,2022-10-31
4f35c5f01ec57b6a,,384846792,13480499,0,0,398327291,2022-10-31
0272c0c4959d9697,,272172272,35871454,766353,175540,308985619,2022-10-31
7769937ad9dbd490,,9007084972,159327225,1179017,218522,9167809736,2022-10-31
b1fc12afda4efa77,t-mobile,775977,249341,445602,141341,1612261,2022-10-31
12cb25902df1333f,metro by t-mobile,12168961,432217,869569,282742,13753489,2022-10-31
f7df55c168496d1e,mint,663026067,53797396,9834,3955,716837252,2022-10-31
fd0c68600116e52a,t-mobile,92551140,1661785,0,0,94212925,2022-10-31
72ac3cd7db4b144a,t-mobile,5855624128,159937734,19369,11235,6015592466,2022-10-31
697a82b096f2508f,mint,911385140,60422613,154490,58026,972020269,2022-10-31
779ebd1b5eb22ceb,mint,2258474948,66082402,15414,6734,2324579498,2022-10-31
ea8cfd11e33001a8,,3082885611,65618507,12521,240685,3148757324,2022-10-31
d82ca15975bfc3b7,mint,137093344,1931108,0,0,139024452,2022-10-31
87b63d27b178abb7,mint,607233581,21540112,123475,45354,628942522,2022-10-31
93187abfae4b7819,mint,858303,242813,60592,19467,1181175,2022-10-31
1b675598595baa94,,1065999726,40095755,0,0,1106095481,2022-10-31
5d63ccc12f2e2304,mint,784537,259047,0,0,1043584,2022-10-31
3241eee09e335a27,t-mobile,47346,13862,172542,63989,297739,2022-10-31
e1632a41c4a46ab8,metro by t-mobile,211721649,30362697,1190923,241275,243516544,2022-10-31
8c3e4efb4a312018,mint,309804571,55577196,558364,58344,365998475,2022-10-31
af17b385110e4c4e,mint,511878,49668,0,0,561546,2022-10-31
748483ac6bdd71c3,,148089145,3454427,0,0,151543572,2022-10-31
93e13788f0e3c9d3,mint,803931855,20822209,227,170,824754461,2022-10-31
1dcd4f31fe120a22,t-mobile,354370,216517,5789,1776,578452,2022-10-31
7265a997349b07b9,home,1653503,422278,0,0,2075781,2022-10-31
b5d40fee5343ea4e,mint,813936600,52413513,0,0,866350113,2022-10-31
10f180383370a292,,770603038,36178599,652088,50845,807484570,2022-10-31
69a319e50c3ff49c,t-mobile,958554963,74842989,92108,33408,1033523468,2022-10-31
57c14e3074be842d,,72633604,1949857,0,0,74583461,2022-10-31
e0b29b1e0b16531b,,214960188,3816425,0,0,218776613,2022-10-31
b87055aea5a963af,mint,495630452,4917474,0,0,500547926,2022-10-31
b311d894b0db2c40,t-mobile,252566478,6911573,0,0,259478051,2022-10-31
051651e7fce0df05,t-mobile,438595942,34312501,0,0,472908443,2022-10-31
86f1e672b2c33507,verizon ,2542086227,75454554,923818,112431,2618577030,2022-10-31
d85edec3009f50ca,,170021281,3685144,0,0,173706425,2022-10-31
bdfbbb3505443002,at&t,606131897,69547997,13618,162286,675855798,2022-10-31
e4e14fdc5d2b034a,at&t,1478846048,84309649,1175767,181562,1564513026,2022-10-31
673c1e5458a6706f,verizon ,746165914,11433103,1294419,76691,758970127,2022-10-31
2dff93f9381f8436,t-mobile,67571975,8098300,46188,13495,75729958,2022-10-31
ddef8cbeb798cc44,verizon ,135636768,23695749,0,0,159332517,2022-10-31
fd651efebe561316,at&t,825590109,72478117,900522,114380,899083128,2022-10-31
f4ac6278045976f3,at&t,1145500880,102533812,621063,31198,1248686953,2022-10-31
409289bba6c2f076,at&t,171163909,25952707,239528,94223,197450367,2022-10-31
0d1b4aa3d89a3056,mint,150882998,14083883,114172,42388,165123441,2022-10-31
0ec3326a02046bd1,verizon ,1178387,293601,0,0,1471988,2022-10-31
f98e122a5b548314,verizon ,629552707,37378937,0,0,666931644,2022-10-31
edc2ca2b20e6b12f,verizon ,830359955,12210326,0,84,842570365,2022-10-31
aa200fc139b6f7f0,,32399,6994,0,0,39393,2022-10-31
a75ecf776a5f7f6e,verizon ,0,0,43820,11476,55296,2022-10-31
c2b55031bd25e323,mint,65691,124498,615026,224623,1029838,2022-10-31
365abe8169dcb070,,524763136,64006722,100190,36926,588906974,2022-10-31
1aa9529ba85168b8,,659453195,83228350,576818,82327,743340690,2022-10-31
b3218a6389d07391,mint,334278096,17457948,1467458,244615,353448117,2022-10-31
c1e952457861c39b,t-mobile,3220035971,71425037,6962,2355,3291470325,2022-10-31
9af788875f5f9eed,mint,158011637,10492625,17305,114052,168635619,2022-10-31
0828989eb1b9422f,at&t,0,0,18562,7707,26269,2022-10-31
72adde010e04d789,verizon ,137414188,1489118,1073796,224139,140201241,2022-10-31
ce3493fd77ad24bc,mint,145423805,1567905,1598816,310258,148900784,2022-10-31
58c5b8ee2b3321d6,,70500,217650,0,0,288150,2022-10-31
d91ca602779a1810,mint,965111690,50561913,189297,58024,1015920924,2022-10-31
47d9a8c4c3c29c37,,147901276,1371445,0,0,149272721,2022-10-31
6e7605c567fad275,at&t,1360808761,84767489,1288219,266203,1447130672,2022-10-31
77162fc6225547a4,at&t,956825948,56809221,859225,175463,1014669857,2022-10-31
0ccb2997e8a1c662,at&t,447646127,59878149,21075,6178,507551529,2022-10-31
597aa668e61252ea,at&t,1239696341,132664015,770519,61114,1373191989,2022-10-31
dabf63b62d33ba75,verizon ,19334902042,369586208,22263,16565,19704527078,2022-10-31
3024000070cbd197,,148379560,1639971,0,0,150019531,2022-10-31
230173c20a8c52bd,mint,3668754762,105274647,1196823,305270,3775531502,2022-10-31
88e526c277964352,,1396427788,32349796,0,0,1428777584,2022-10-31
1b004b3813c71e10,verizon ,124804235,2549170,1303931,99964,128757300,2022-10-31
0f11f4d9ddbccfdc,verizon ,814632,253564,53224,16029,1137449,2022-10-31
7142755d6b877342,verizon ,627982371,38716491,674874,59428,667433164,2022-10-31
fb4ccbf1f60d35fa,,460376474,23040614,1257713,480101,485154902,2022-10-31
86f7e0093acee62b,at&t,348345429,42449187,1022782,211487,392028885,2022-10-31
7fcd193f90068052,verizon ,1024761362,76561970,6874,1610,1101331816,2022-10-31
35b4be1c220bf501,at&t,0,0,628236,29067,657303,2022-10-31
475462958741e7a2,verizon ,551098213,40033071,84,84,591131452,2022-10-31
c192bfdd3375e07c,verizon ,436145870,44602882,2029496,290008,483068256,2022-10-31
a2225a2e32b6f2f7,verizon ,121893103,19371973,52402,14066,141331544,2022-10-31
fa6401a2cf835515,verizon ,924377975,74968799,6713,2004,999355491,2022-10-31
729ef8502bda3396,verizon ,749756,206999,8030,1469,966254,2022-10-31
af7f704c37b70c1b,verizon ,1216502702,87966320,649038,33674,1305151734,2022-10-31
e38ff79584277c8e,,307802924,30062404,1503623,401384,339770335,2022-10-31
c923b2e80a8c76e1,mint,80155,35915,0,82,116152,2022-10-31
af60cc964724e3e9,mint,493014078,27599057,1342016,88375,522043526,2022-10-31
85484349ae05c3a5,,95902160,2067319,773894,260063,99003436,2022-10-31
0176ed5a593e595a,mint,1507324255,60417617,1430298,264430,1569436600,2022-10-31
3fc0cadecfd69daf,t-mobile,1600754369,29607081,13535,4077,1630379062,2022-10-31
26ec431fa0595335,mint,31573962,4531867,587403,14469,36707701,2022-10-31
6fe63b0d726e478f,mint,487001286,15640728,1761794,257224,504661032,2022-10-31
f991bb73824cf2ab,mint,590161990,9611291,1333119,91604,601198004,2022-10-31
f8cd5dacdca9340c,t-mobile,445391492,33099486,1183058,85623,479759659,2022-10-31
2036cbdc3ec5d800,mint,396868105,42217395,16218,5843,439107561,2022-10-31
7b28dc6be706f86c,mint,134554159,10100970,0,0,144655129,2022-10-31
8e491ba954c183e1,metro by t-mobile,664282530,43013236,658,1918,707298342,2022-10-31
6cf9e613c32eac05,mint,828865500,64797528,1161465,200620,895025113,2022-10-31
12b43ebfa2b2277f,t-mobile,0,0,584800,39348,624148,2022-10-31
cf03b1284fad79bc,mint,225178871,4148404,291673,107814,229726762,2022-10-31
4950fb35e819d1e5,t-mobile,866035529,76021714,87534,27265,942172042,2022-10-31
9a5b47ec0b16e6c2,mint,793126411,48496022,395333,138286,842156052,2022-10-31
16469260f92096a2,mint,451620179,20987112,84,84,472607459,2022-10-31
fcae8088c9d24891,ting,3870920862,87971517,653471,36759,3959582609,2022-10-31
89112bde9e680885,mint,818186,226011,185931,59450,1289578,2022-10-31
8fae690bfb674b89,mint,62351720,6664439,13097,4939,69034195,2022-10-31
7ec98282fcfa3c70,t-mobile,692629138,65059061,611398,73729,758373326,2022-10-31
29916c64fee19a60,t-mobile,767397,227548,78094,17810,1090849,2022-10-31
cd3531ede4a7e6e9,mint,534301796,23664396,0,0,557966192,2022-10-31
8dc0201814f09f07,mint,791713,212832,332,985,1005862,2022-10-31
194a28bf938ff8ef,t-mobile,738541227,32047118,1821025,254414,772663784,2022-10-31
1ae93ab7128168ad,,540238,266083,92098,16056,914475,2022-10-31
e920e6568a54ff2f,mint,615553045,10645494,921810,427972,627548321,2022-10-31
25bd3792186bf991,mint,43001610,1418945,0,0,44420555,2022-10-31
d419268ea45f6122,mint,581545724,12869970,0,0,594415694,2022-10-31
2daa239cd5daf161,,111359486,2084897,0,0,113444383,2022-10-31
bf126214d5b2e20d,,698734,194340,7551,1688,902313,2022-10-31
d6adf581e377b884,mint,796603,233487,581056,185468,1796614,2022-10-31
9890c46069c118e0,t-mobile,42444255,2593624,20515407,900756,66454042,2022-10-31
58a55f8cd83c771b,mint,447797796,23175216,655906,46452,471675370,2022-10-31
541b746644db2f52,,285953105,6001683,0,0,291954788,2022-10-31
c5e5bf2647fee831,mint,46580,9757,0,0,56337,2022-10-31
1b89bbc85421d2d3,mint,1029734052,22794765,0,170,1052528987,2022-10-31
663dd69a55a32425,mint,7703955196,164484298,39964,15670,7868495128,2022-10-31
4deb220c8660146b,mint,562897702,53941981,1192773,66820,618099276,2022-10-31
d82932273483da8d,,237645463,9768446,0,0,247413909,2022-10-31
e691bed24a201121,t-mobile,148457242,2647002,653388,187769,151945401,2022-10-31
61ec95ff4d9f405e,mint,1355501843,86050997,20570310,588106,1462711256,2022-10-31
12e8e309df336670,mint,258024577,27481164,0,0,285505741,2022-10-31
4420172a1ea8a6d0,t-mobile,813979369,44893947,562003,132932,859568251,2022-10-31
c6d9530842bde804,mint,641219428,61965398,129359,48578,703362763,2022-10-31
37a76b25cc3313b6,mint,399938114,5713756,13354,2030,405667254,2022-10-31
9a18f97e9be995b4,t-mobile,1353967409,97000851,0,2040,1450970300,2022-10-31
a300bf0e160e60fb,mint,424694647,8987030,26725,5801,433714203,2022-10-31
c30335830c567630,,152043679,9872744,553664,25491,162495578,2022-10-31
eb5ad2084393018e,verizon ,1755455368,82362210,7477,1766,1837826821,2022-10-31
c136a3dfd848cef7,,21374,7691,0,0,29065,2022-10-31
a9d460e769d6210c,verizon wireless,186097028,6214085,0,561,192311674,2022-10-31
c39ba1e9d8d16221,at&t,0,0,1138560,139460,1278020,2022-10-31
6509951398652444,at&t,221048914,29973078,1281764,273012,252576768,2022-10-31
208f6be3cc86402d,verizon ,1226331010,94892738,1362316,496906,1323082970,2022-10-31
1eb2c0087aef933b,at&t,217849,88224,951940,289221,1547234,2022-10-31
6104c332093a8683,verizon ,467758692,28240469,1447506,460148,497906815,2022-10-31
291978e194c2a478,verizon ,1173080817,45673715,6802,2056,1218763390,2022-10-31
0d08862f83bdc491,,11025153,1857026,41932,12403,12936514,2022-10-31
7b3e90af63bb356a,at&t,652428919,63737168,1070611,192919,717429617,2022-10-31
d0e5c457c345451e,at&t,683497262,65351090,103932,30965,748983249,2022-10-31
6f9a74360f10827f,at&t,727690514,68836251,1115230,186103,797828098,2022-10-31
98bea89bff232bf8,verizon ,875787654,64941106,331265,39402,941099427,2022-10-31
ca5ab7e6f68ef591,verizon ,537879692,38662908,1310095,68533,577921228,2022-10-31
9903b2cb9a1f415a,mint,420064090,59735843,2614775,545563,482960271,2022-10-31
c53d5ea2c0b9d27a,,1047307,396809,89161,30790,1564067,2022-10-31
9442af2deb0fe717,,628143,181165,572339,206548,1588195,2022-10-31
8e96a2ed3ebd9964,,972303394,14163182,169028,47064,986682668,2022-10-31
6b5404a49d1a3019,t-mobile,227442539,3415754,10098,132330,231000721,2022-10-31
7ed597f174181e63,verizon,0,0,0,0,0,2022-10-31
77958bc998f2d01b,Verizon,0,0,0,0,0,2022-10-31
9740eadf3be37666,verizon ,0,0,0,0,0,2022-10-31
7c2dcf486c46352f,verizon ,0,0,0,0,0,2022-10-31
71d5e85b2f7884b9,,63850512,1803724,580,9233,65664049,2022-10-31
0b8ab9083536487b,verizon ,0,0,174104619,2764731,176869350,2022-10-31
06a2f425b167bc53,t-mobile,0,0,0,0,0,2022-10-31
e59f046dae4c0f54,,33632,129733,0,0,163365,2022-10-31
4a4420d6c0404e8e,at&t,37619590,562439,0,0,38182029,2022-10-31
d2e4940ff6b33f89,cc network,537868381,8790770,0,0,546659151,2022-10-31
d1b4d588866574e7,,128311521,9017118,0,0,137328639,2022-10-31
531d04dab61e684f,,511887,218362,112334,42273,884856,2022-10-31
833649688c0e2a5a,,1165712960,22392862,0,0,1188105822,2022-10-31
33ce39636be102b5,,780773121,14115359,0,0,794888480,2022-10-31
0d88bc4fc78056ea,t-mobile,0,0,0,0,0,2022-10-31
f648a6228fcb9fad,t-mobile,8477758669,193769090,444194,161932,8672133885,2022-10-31
b950fd08dbe322cb,t-mobile,1041879174,15249540,0,0,1057128714,2022-10-31
eb3214964f182f4a,t-mobile,0,0,0,0,0,2022-10-31
4ba409ee3a7087db,t-mobile,0,0,0,0,0,2022-10-31
c484274594ae533c,t-mobile,0,0,0,0,0,2022-10-31
69622de4dd638472,,1664558852,26275487,0,0,1690834339,2022-10-31
cb54be6a9dfacf9b,mint,10685130363,245583511,35235,22804,10930771913,2022-10-31
368382e87715a603,,888636419,52344459,0,0,940980878,2022-10-31
2681a988c2a96af3,t-mobile,866094023,56151791,1947558,360114,924553486,2022-10-31
123778e011ce95e3,t-mobile,719203254,77308059,1969054,346241,798826608,2022-10-31
969c38162ca9d967,t-mobile,0,0,2136081,353292,2489373,2022-10-31
f574b08a96c65b6b,t-mobile,251111,67150,801244,250545,1370050,2022-10-31
183c844f9e831db1,at&t,0,0,0,0,0,2022-10-31
0f4beaa7e37d8d8c,at&t,21245,8812,0,0,30057,2022-10-31
79e4e1f2d41f1eb0,t-mobile,753755526,66910605,0,0,820666131,2022-10-31
39e503c6da37f58a,t-mobile,0,0,0,0,0,2022-10-31
5115586081f1e275,t-mobile,0,0,1044141,76363,1120504,2022-10-31
110dcaff721963a3,t-mobile,2066169271,31373300,0,0,2097542571,2022-10-31
ccd0c47e25fc731b,mint,3393206789,54929385,1277953,258391,3449672518,2022-10-31
e01e22190f411a69,t-mobile,0,0,0,0,0,2022-10-31
41fefbf5f901bc27,,901235784,16924144,0,0,918159928,2022-10-31
b456b0e52df2eaae,mint,1465745,248407,35669,307310,2057131,2022-10-31
21b74ca3834e4ce2,verizon ,118033611192,2147000641,1792619,273402,120182677854,2022-10-31
b7906c0ba7ce3a6d,t-mobile,0,0,0,0,0,2022-10-31
51d6e4483f0a6660,mint,2567628709,90499945,160779,61904,2658351337,2022-10-31
8f6d643ad762a7b7,t-mobile,883943,260516,855705,55417,2055581,2022-10-31
7356dc2edd04b590,verizon wireless,0,0,0,0,0,2022-10-31
ca5f0225b7f57482,,687923,219289,0,0,907212,2022-10-31
bd6441b97d8b9fb2,,128159,231422,168574,124987,653142,2022-10-31
51e9de69db537625,verizon ,8134488134,185885166,6661,1845,8320381806,2022-10-31
656d8abbe24205c4,,259464755,11122607,2298344,1287795,274173501,2022-10-31
953e04bb94f18613,t-mobile,0,0,0,0,0,2022-10-31
08d12720042c07f0,t-mobile,3325653914,95278463,160941,65318,3421158636,2022-10-31
73f2145e7b1e633f,t-mobile,129813642,20063879,0,0,149877521,2022-10-31
6261afb00370dc4b,verizon ,432437716,7666598,271461436,7152960,718718710,2022-10-31
89626609c68ca75e,cc network,0,0,0,0,0,2022-10-31
f0e4223d273ea7b3,t-mobile,405485778,19368596,0,0,424854374,2022-10-31
c3f9e2b2cc330060,,1578719584,26690642,0,0,1605410226,2022-10-31
cb43b4a327d9d8e6,verizon ,0,0,0,0,0,2022-10-31
be1dfbe47826f84c,,669506043,18604510,47007,474978,688632538,2022-10-31
d792b53984be3943,,784655138,13554692,0,0,798209830,2022-10-31
44cd89e6eea27fad,mint,3384788417,97241033,1803397,306960,3484139807,2022-10-31
c54a17db1802cd2c,,900317279,15765253,0,0,916082532,2022-10-31
d6f3805fa32c4ff1,,1493829274,59297900,19843,8054,1553155071,2022-10-31
00c137f6b8112357,,647385,168197,0,0,815582,2022-10-31
f3da20968db941fe,t-mobile,97817,236561,52598,27508,414484,2022-10-31
09432652f4bd23b4,,89908,49579,0,0,139487,2022-10-31
228e8176ad6d9c8f,mint,1092453266,24799700,145554,44999,1117443519,2022-10-31
31fc927da23884fb,mint,786177881,45790988,813088,102676,832884633,2022-10-31
bee60643a9fd4668,mint,146828600,18157397,1312839,75115,166373951,2022-10-31
05d573753473af52,,790356,270320,0,0,1060676,2022-10-31
d925a612e68faa77,t-mobile,3228258437,97452738,1662552,225085,3327598812,2022-10-31
630a6d40a4abd651,mint,670618986,49211192,958849,171306,720960333,2022-10-31
1a23d8fe5dc0bdf5,t-mobile,1484283304,94659487,133553,56431,1579132775,2022-10-31
328b43430f3a46dc,mint,11259157514,228292573,681337,33987,11488165411,2022-10-31
75a76c2badafad70,ting,20758,123185,8635,2352,154930,2022-10-31
2c19d08c8604d16b,t-mobile,810428,271371,8768,3657,1094224,2022-10-31
f778a62681a67fe4,verizon ,60710755,1541747,271447,79968,62603917,2022-10-31
d9932099cff3fd1c,verizon ,0,0,78967914,1394008,80361922,2022-10-31
1c4996749b820e6b,verizon ,0,0,71728814,807894,72536708,2022-10-31
5572aba18f3d98ea,,21090,4311,0,0,25401,2022-10-31
82a4d155548911f7,t-mobile,735074,207649,905293,270160,2118176,2022-10-31
8f5400424e2f2895,t-mobile,1477932568,59495649,7044,2284,1537437545,2022-10-31
3abcfd316dd83d4f,home,489523352,35459021,1810118,234504,527026995,2022-10-31
20816889044ba018,at&t,968638203,34001488,0,0,1002639691,2022-10-31
ef488d2e09727005,home,621939,184157,0,15045,821141,2022-10-31
48ec313abca866a7,t-mobile,194817,46998,19530,170215,431560,2022-10-31
7954107e3c0234d9,t-mobile,453538054,25169655,13710,2246,478723665,2022-10-31
e0bf8d196c755479,mint,670509333,22637377,0,0,693146710,2022-10-31
c3bd835134baf0bc,mint,139,198,152014,375164,527515,2022-10-31
298054a122e4d048,mint,908154,238809,77482,198059,1422504,2022-10-31
6f30b1959f35085d,verizon ,609924,164969,0,0,774893,2022-10-31
905e90ff686f9b27,verizon ,3095823332,104212072,144808,296005,3200476217,2022-10-31
a1354bd308a49c40,at&t,95222,46913,16690,4876,163701,2022-10-31
b3029735d7cad78f,,1444953174,73958427,11472,4670,1518927743,2022-10-31
cdb9c28d757dd43a,verizon ,3715315,229569,970802,364127,5279813,2022-10-31
daa255955dce54dc,verizon ,189226228,2884851,1097517,675136,193883732,2022-10-31
33a98cc6e453117d,at&t,1019398,405625,12907,12931,1450861,2022-10-31
202c83a471a06369,,853491,245420,217314,69537,1385762,2022-10-31
39bd2c4b83da9b93,,120188,44360,0,0,164548,2022-10-31
433cb908db9c9836,t-mobile,20261,7695,8562,2352,38870,2022-10-31
75e954a2f7deb73b,mint,333692298,2626338,1574,7065,336327275,2022-10-31
ea5868d4c37149d5,mint,121098893,1342106,185447,73210,122699656,2022-10-31
06a7d9648ae08718,,849363,311332,860135,372393,2393223,2022-10-31
422f80c74584bb9b,mint,228887331,9339483,5462,1036,238233312,2022-10-31
82d34039976258f1,t-mobile,3236304102,68964916,285568,30037,3305584623,2022-10-31
a4df772d1141c669,mint,776647062,30674882,975636,193913,808491493,2022-10-31
077f2f1fb054f045,,570002,71533,0,0,641535,2022-10-31
fc90ca2c05cf0575,,1675203463,33480538,0,0,1708684001,2022-10-31
3d9da6a68316c1d7,verizon ,1526928016,27067336,298203263,4288049,1856486664,2022-10-31
8e5d6e977a1a33bf,t-mobile,836077,271177,271107,80883,1459244,2022-10-31
968c0f5fefd30406,mint,45409758,6886103,159017,56748,52511626,2022-10-31
12ef7ee6cc9521d2,mint,888209782,53628021,44981,17067,941899851,2022-10-31
4ef9bdc1ed37ad9c,t-mobile,841351,226534,0,0,1067885,2022-10-31
87898a0bf462403c,verizon ,122606470,2903545,13644,2147,125525806,2022-10-31
a7b153099ac3d90d,at&t,152496725,2293548,144884189,2935347,302609809,2022-10-31
1b5911d1940886c6,mint,782948,291023,0,0,1073971,2022-10-31
022b5c582de65e4f,t-mobile,4952232535,139199516,36393,12382,5091480826,2022-10-31
d1513c612472cefa,,722179,234945,71172,22972,1051268,2022-10-31
ee0f60306d5c8c71,verizon ,372663880,45925269,2005709,309311,420904169,2022-10-31
3ed687496de75168,mint,784140,271044,3793567,103088,4951839,2022-10-31
0997bfa1409df864,verizon ,409718028,5970939,50679602,1158042,467526611,2022-10-31
1d14ea97de168f04,verizon ,19138156095,350029072,988856,155987,19489330010,2022-10-31
c1ce4e615689c0cd,mint,212281628,19237877,864488,196061,232580054,2022-10-31
f519669b6b9fb078,t-mobile,79221,33647,0,410,113278,2022-10-31
20edd633409997e6,verizon ,2762438001,74768744,252160,89495,2837548400,2022-10-31
6d0b10ead00cf713,mint,0,0,942004,299749,1241753,2022-10-31
4b2604ad2ebcc0cd,mint,663788,200824,197899,73433,1135944,2022-10-31
e2f163dca8cd0f25,ting,525020213,62038861,503396,45555,587608025,2022-10-31
ffc98349834cfd6a,,301865587,6537561,492,2080,308405720,2022-10-31
24bff2d662954752,t-mobile,83577,27542,1245206,281354,1637679,2022-10-31
656f48f326b45f7f,,139092596,10713807,0,1040,149807443,2022-10-31
64071959b27aee5e,t-mobile,214147184,21717092,102,183,235864561,2022-10-31
761c2f367bb3d9e1,,158529985,1880867,0,0,160410852,2022-10-31
73a178d7d8b42e5a,,807077,279388,439998,159514,1685977,2022-10-31
550fdabfce6c9c50,,27098268,790986,0,0,27889254,2022-10-31
55930edadfca7ffa,,889572,309526,0,0,1199098,2022-10-31
c2b9472fc34b7c54,mint,420974638,25942450,742801,63306,447723195,2022-10-31
81b94e38334d43ee,mint,693223510,55647997,848446,127070,749847023,2022-10-31
3845e322dcf6df61,,35120,78523,0,0,113643,2022-10-31
49e1c5d2af8dab1b,t-mobile,309575015,3423105,0,0,312998120,2022-10-31
edbdce07b41fb62a,t-mobile,469053090,24757073,690214,149193,494649570,2022-10-31
dd4d328e0f843bf9,home,17478,6907,0,0,24385,2022-10-31
aa440f3e103bbee2,,443633028,25785473,0,0,469418501,2022-10-31
2205af0c1e60ca6d,verizon,959442909,19585809,872621,158891,980060230,2022-10-31
091e27b0daa094a4,,1565078631,62371896,243922,85969,1627780418,2022-10-31
e32c89295c3c5c9b,mint,785046,253621,324621,134448,1497736,2022-10-31
0604e94cbef1f048,mint,952271201,60803844,90725,31627,1013197397,2022-10-31
286e19a36dee977e,t-mobile,807636,245763,183348,182436,1419183,2022-10-31
f65f7cc03215185d,mint,235938,83813,0,0,319751,2022-10-31
b8d1381c0422de6d,,460630247,31782662,54608,21082,492488599,2022-10-31
33dfb2430e20b26a,,149079103,2881030,0,0,151960133,2022-10-31
e034853e39545bc7,at&t,128244259,2024239,0,0,130268498,2022-10-31
3b68e411d25265e4,at&t,0,0,678733,270524,949257,2022-10-31
cc7745bd846f72c7,mint,16050,5568,0,0,21618,2022-10-31
ef92bc03f282efa3,mint,3193514646,47195854,18104,20841,3240749445,2022-10-31
23aa9757a06d6c55,,601431,206938,635612,336090,1780071,2022-10-31
df96054feca00028,t-mobile,19646358,448995,0,0,20095353,2022-10-31
c65bbc69f0586731,,610558053,69694061,134948,24850,680411912,2022-10-31
08d03c3263c4addd,,334351,85965,0,0,420316,2022-10-31
890556dd819bcbf8,mint,793882,214926,141207,35781,1185796,2022-10-31
d13d9d99636ac025,mint,828248,265783,261622,141238,1496891,2022-10-31
b3cb81bfb83ac467,,799322,223521,161365,57141,1241349,2022-10-31
f55abd462376a535,,922093823,16725969,60032675,1396940,1000249407,2022-10-31
64b37897f2534856,,857162126,31560049,7814,3038,888733027,2022-10-31
2daa60caf3764972,home,344367,234968,285290,613349,1477974,2022-10-31
b79d0fa78a42518c,home,919339005,46378867,40747,14928,965773547,2022-10-31
213aa03e9204ad74,home,465571701,54831636,864889,106802,521375028,2022-10-31
0e64033c0910af24,ting,849286,264889,412805,151793,1678773,2022-10-31
1564106ae01d0f97,mint,417909252,10834668,0,0,428743920,2022-10-31
5099de73f36823e1,t-mobile,60322,26080,218,2001,88621,2022-10-31
81f527d9d60a5de9,mint,340855405,12566373,418,250,353422446,2022-10-31
cb97513f14cfba0b,mint,577972,164433,7352,1856,751613,2022-10-31
aedefa66f55968cb,mint,681218,241152,7082,1948,931400,2022-10-31
596141b5a7d116b6,mint,567601719,8820730,2007981,324625,578755055,2022-10-31
5e8f62c60bf13251,mint,3570563171,104522292,124256,44521,3675254240,2022-10-31
539846c1c44d8388,mint,282447189,3303615,14649,5497,285770950,2022-10-31
0358303e25ebbb33,mint,0,0,36967,16121,53088,2022-10-31
347441030f02876e,t-mobile,836172,246909,443710,157221,1684012,2022-10-31
9c71c75ca3aa08fd,,137995426,2770733,0,0,140766159,2022-10-31
dc7648cb61120b89,mint,677565,212335,0,0,889900,2022-10-31
e68989a40f17994c,mint,114542702,2021616,198794611,6046812,321405741,2022-10-31
4502c4c0e982fb39,mint,373164195,25700457,0,0,398864652,2022-10-31
037c89b9000cdb00,mint,1405700888,91614410,1320460,292378,1498928136,2022-10-31
4fb256203e3c422c,mint,455211243,42424974,113646,46837,497796700,2022-10-31
154ab7dc821d4f60,mint,12594991,640024,1258392,248798,14742205,2022-10-31
00b571218fc48c41,t-mobile,9267841607,151502261,6493,1876,9419352237,2022-10-31
174d08af77f1b616,mint,922493940,79838433,1034235,179420,1003546028,2022-10-31
22d379379efe8754,mint,404029802,15123469,2001528,332083,421486882,2022-10-31
1572b424dc717237,,7137127490,119125534,0,0,7256253024,2022-10-31
1b81541939695b70,,140669587,2337528,0,0,143007115,2022-10-31
3d26237839b9ed32,t-mobile,606793678,50918552,238652,9258,657960140,2022-10-31
40e82bc664be91e8,mint,533825157,20096784,628034,36628,554586603,2022-10-31
16cc525675c1cbd3,mint,531045024,23840669,14303,4005,554904001,2022-10-31
92ed57615e2cf484,mint,0,0,924363,131657,1056020,2022-10-31
9a5b7d687f56ffbd,mint,1079684056,72702606,28332,10112,1152425106,2022-10-31
996538350ae23acf,at&t,462781318,13217341,0,170,475998829,2022-10-31
7d2cf05716af7626,,554389622,6989865,0,0,561379487,2022-10-31
00735569e95e9ba0,mint,586410647,42443264,50276,26452,628930639,2022-10-31
2ea750b363fe4b36,mint,834356,274366,138,322,1109182,2022-10-31
9ff1215b7a618ddf,t-mobile,57704745,1397898,1787597,151411,61041651,2022-10-31
a94b45d9158171be,,20618878,628238,0,0,21247116,2022-10-31
0f49dcd2b738efa9,mint,396238366,11645375,0,0,407883741,2022-10-31
9a39eccd5e645f55,mint,70861345,1556105,144659,58912,72621021,2022-10-31
038566d9d3d1162c,,111476621,3596009,0,0,115072630,2022-10-31
59f11a66d2fd7f70,mint,1356529466,40891096,28599,14038,1397463199,2022-10-31
7ecd4ddc91659306,t-mobile,327045940,37539027,20842,4847,364610656,2022-10-31
69bc292cff30fddf,mint,12918678,1113804,1648,26976,14061106,2022-10-31
4e9fb72074b59a99,mint,75346638,1710689,22587,10971,77090885,2022-10-31
ce892523c1d13e32,t-mobile,73739304,2023857,25694,307270,76096125,2022-10-31
a8d328028e40e0a7,mint,351623382,24636181,677330,49860,376986753,2022-10-31
ae58cf718a4e76ac,mint,511421,189510,1012827,321548,2035306,2022-10-31
1ccfa6e0a1bd62f7,mint,283579,392921,10380,5810,692690,2022-10-31
e34b186789e9c757,,1031109605,45499090,1591748,294618,1078495061,2022-10-31
23d9b72b24248f71,t-mobile,668772050,42967856,4644,30288,711774838,2022-10-31
a5dd379804219783,,45621284,2077830,0,0,47699114,2022-10-31
93b17ee011048ee1,mint,983153549,79701817,32702,9293,1062897361,2022-10-31
b40cea2f3b9742c5,mint,26800318,3056875,672506,37457,30567156,2022-10-31
566eb7604e7bb353,mint,847135,281430,638065,223026,1989656,2022-10-31
dc3de96bdd1cdb41,mint,0,0,764902,259005,1023907,2022-10-31
9b8feccb4ae52190,mint,899525097,80147769,223,226,979673315,2022-10-31
5bb8be51f2c93179,mint,9825390,1108289,684154,85274,11703107,2022-10-31
bbce3171f10253e3,mint,263167293,8336224,962435,78461,272544413,2022-10-31
c182bc8b35420d18,mint,332476213,43888990,6612,1889,376373704,2022-10-31
740c7ed88915742b,t-mobile,348408976,7262276,697477,666546,357035275,2022-10-31
2397c92334a21e50,,90987,21525,0,0,112512,2022-10-31
0d91bd8d37709a81,,305599498,15942441,15832,182204,321739975,2022-10-31
5ba3e21e7c7c2059,mint,75147,134370,11730,2147,223394,2022-10-31
cc354cc1828b7981,mint,1440516,258381,1167969,184288,3051154,2022-10-31
030715e78c4bf175,mint,763022814,58454600,0,0,821477414,2022-10-31
b0040bf9c38106ba,verizon ,2009355254,44641205,2073335,326820,2056396614,2022-10-31
1e660de3baa0303c,verizon ,795549527,74200488,26861,7377,869784253,2022-10-31
3c5db2998296fe21,verizon ,419464810,7033579,895675,258815,427652879,2022-10-31
1dea82cedc2f3961,mint,52018453,1647718,1313216,244496,55223883,2022-10-31
e57c720f00ef733c,verizon ,992055639,53477855,667469,72725,1046273688,2022-10-31
6cdfa7c181c70647,t-mobile,916650345,68276619,717402,48652,985693018,2022-10-31
620c3a00110574aa,at&t,192481,81656,435505,122189,831831,2022-10-31
88d6849efa689f26,,472174366,29176916,72639,30390,501454311,2022-10-31
d4be86d23a2d72e2,,80221951,2813250,0,0,83035201,2022-10-31
c48c76da034c8ae2,mint,678689,195513,681768,306342,1862312,2022-10-31
1caff9b7612abb38,mint,1105760218,79656432,1057632,183602,1186657884,2022-10-31
dc1b15b2711dd276,mint,3071017433,99395461,75075283,2497847,3247986024,2022-10-31
72bd7a7b60a2997e,mint,613728443,61761529,37130,13793,675540895,2022-10-31
4ed81e9ecf4ebef7,mint,158445601,2272923,6072,52023,160776619,2022-10-31
31af5ab63e9de15a,mint,43138,13224,887458,304473,1248293,2022-10-31
b4c042e4665dffe2,mint,722475684,51001926,696417,40501,774214528,2022-10-31
71d10eef22dd62ae,,138499453,2723145,0,0,141222598,2022-10-31
b0b964cc9331f2bb,mint,162557,49845,0,0,212402,2022-10-31
d446bb4d7adcc7a7,red pocket,375652455,38673763,1885732,362749,416574699,2022-10-31
718c128b0280fdb1,t-mobile,870976249,99375578,4164,1895,970357886,2022-10-31
9a0e605355fa1d14,mint,0,640,0,0,640,2022-10-31
b46ca4dccb82e587,mint,66196526,6038314,0,0,72234840,2022-10-31
ccf188514d8754c2,mint,0,0,488925,36479,525404,2022-10-31
bb86052699bfceb1,,526377724,11772408,6672,1972,538158776,2022-10-31
475ce0a7cbbbf95b,t-mobile,1077831896,46804892,202085,76173,1124915046,2022-10-31
331e9163eb89dc42,t-mobile,903926485,52825931,42713,12647,956807776,2022-10-31
f8c3cfb801733af3,,92602965,1311163,0,0,93914128,2022-10-31
79930fe71d9de64b,verizon ,0,0,1122657,177660,1300317,2022-10-31
681f731fcf4c7112,verizon ,0,0,613984,20410,634394,2022-10-31
78e58ded9be461fa,,143762975,12050224,0,0,155813199,2022-10-31
d970fe3f2bd8763f,t-mobile,1305593632,47365455,71798,29430,1353060315,2022-10-31
70b5866e7ef498d3,verizon ,1904364134,71168760,1040132,152534,1976725560,2022-10-31
511d6c5192cbb1b4,verizon ,652465717,72717891,178146,58558,725420312,2022-10-31
e6627ba622c046c6,verizon ,524105016,19411218,1670368,278970,545465572,2022-10-31
61ed70cebeb8ec4d,verizon ,843227865,94600524,1436511,176504,939441404,2022-10-31
82026e68b2810457,verizon ,0,0,1250048,281767,1531815,2022-10-31
1cd509e6c0e5a460,t-mobile,1729027032,74227357,48677,520259,1803823325,2022-10-31
ee70b7736b462c7d,,861693580,16496634,84,84,878190382,2022-10-31
09c5245411ca5f1b,verizon ,186203905,8642660,641717,62859,195551141,2022-10-31
4763ba07e1ac25cb,at&t,4987806186,104236521,21333179,797293,5114173179,2022-10-31
b5b93aff0c2ddd6d,mint,759713561,28847604,1931468,349077,790841710,2022-10-31
79705f86bedea0d6,,89316,51001,0,0,140317,2022-10-31
d8b2922dfef67104,verizon ,408594664,49960818,731299,67003,459353784,2022-10-31
e9f8cbf230be3100,verizon wireless,532281445,58753557,58001,17312,591110315,2022-10-31
e835b7214381e8f3,at&t,855684630,79891962,1306043,116096,936998731,2022-10-31
1a81f9b7d9ccf9fa,cricket,715859186,61364282,72278,25779,777321525,2022-10-31
84140b1fe146a187,t-mobile,1121230133,87175907,17335,10939,1208434314,2022-10-31
b97728298bb041d9,mint,1020906228,68547102,1221181,205693,1090880204,2022-10-31
7170dddd45f8a74d,verizon ,535957371,45986053,41397,12271,581997092,2022-10-31
c796a62787bc4a2a,t-mobile,590597043,65624769,839586,287961,657349359,2022-10-31
1d482e7142680eee,cc network,359159082,18060923,2260615,462754,379943374,2022-10-31
f7aac993e8aab907,,649688769,11476002,0,0,661164771,2022-10-31
437465aa416ffb7c,mint,470118482,51390598,1763638,257365,523530083,2022-10-31
80c5973a73074c91,verizon ,906855585,62099353,933132,77579,969965649,2022-10-31
5bf880f7097588c9,mint,921957056,66512233,1278034,266087,990013410,2022-10-31
cc67ebfedd392e41,at&t,0,0,665801,45234,711035,2022-10-31
2f25b3d3d0a2ce90,mint,831065239,52469870,729478,56507,884321094,2022-10-31
3fabe14bf2db72ed,mint,867418806,54819430,26094,6702,922271032,2022-10-31
33b0ab4aa1d59685,mint,608240464,17484031,1426229,162633,627313357,2022-10-31
c39f31b3a761106a,metro by t-mobile,11768748625,200675604,764581,61148,11970249958,2022-10-31
29656ce8be55aaba,mint,545571592,15845151,862771,168840,562448354,2022-10-31
b3305042e5838a67,,936060,311341,61304,16422,1325127,2022-10-31
121c0ed1472ccfd6,t-mobile,939393066,75063716,70387,30414,1014557583,2022-10-31
ec11125bae80c8b4,t-mobile,339546270,32049148,361879,108226,372065523,2022-10-31
d651b2c09108b324,mint,0,0,70164462,2290264,72454726,2022-10-31
0686393ab60d2bbb,mint,44396384,6864282,239690,109464,51609820,2022-10-31
9237f715f7c00f6b,mint,241369776,14489263,7822,1832,255868693,2022-10-31
b5a5f8c6f6b34d1a,mint,1017263638,49192115,87354,31156,1066574263,2022-10-31
9a5eb68b98333d74,mint,147078,44268,5548,89856,286750,2022-10-31
494dee9dfe0faa87,mint,632632101,38485444,1815756,261259,673194560,2022-10-31
c34565d50dc16991,mint,69862,9716,16534,4973,101085,2022-10-31
ae3873bd8c11595b,t-mobile,372947026,22553460,0,85,395500571,2022-10-31
6ec30430e1619a02,mint,859770,247449,378561,174200,1659980,2022-10-31
b8bfcfd13b2cb22f,t-mobile,172146572,1666527,442549,14528,174270176,2022-10-31
e5c42d2d2f6fd0b3,mint,1148441165,25341281,6565,1876,1173790887,2022-10-31
9067d1b35c218efb,mint,971624749,46364916,219585,77084,1018286334,2022-10-31
71432cc5c0591934,mint,64664839,12107934,15623352,806612,93202737,2022-10-31
29e7ee8e8f5e750a,at&t,225462,84064,37513,21556,368595,2022-10-31
808ef0f75169b257,at&t,189640483,14441636,4974,1258,204088351,2022-10-31
4594190cb83f86cd,mint,641308788,59608240,2013239,254460,703184727,2022-10-31
17d28e1e804de708,spectrum,1066102040,51011394,854247,110509,1118078190,2022-10-31
ea2ed389bae34d55,verizon ,1066708777,53804296,675579,73863,1121262515,2022-10-31
7fe5085366186d36,at&t,0,0,124091,79702,203793,2022-10-31
12b9382237dab676,verizon ,180951929,27778908,0,0,208730837,2022-10-31
d682e35a95c8e7df,at&t,755549987,72942172,651232,261847,829405238,2022-10-31
903f49297c412c48,,180151017,5487108,0,0,185638125,2022-10-31
512af84d52951876,verizon ,414623277,52299936,6661,1689,466931563,2022-10-31
31130e8079368988,,3341878362,35570404,783448,347867,3378580081,2022-10-31
f78f8e70f9a3cf71,at&t,0,0,2212015,613391,2825406,2022-10-31
c1af0427c7513032,mint,3163557782,74601063,663952,27503,3238850300,2022-10-31
5e51d533e5289945,verizon ,1222543320,21658483,0,84,1244201887,2022-10-31
3540dc0ae095f395,mint,748175078,34797210,1013411,170688,784156387,2022-10-31
31d013cdfc5a0e9d,verizon ,37237498281,497658091,0,103382,37735259754,2022-10-31
39a77e86e69370e2,verizon ,707433715,65202330,629808,32258,773298111,2022-10-31
724a84aeba43ba27,mint,303793,497704,0,52,801549,2022-10-31
f79921a9d26bfe4a,t-mobile,15988907294,283450071,1261483,248781,16273867629,2022-10-31
dab17b602df11207,t-mobile,0,0,1292661,469682,1762343,2022-10-31
dcc78ea3f41fc9a7,at&t,3771661004,102673266,1008210,155856,3875498336,2022-10-31
6df659d41b39dcb1,t-mobile,1370728058,49255028,10338,97603,1420091027,2022-10-31
89d6daa3d5cdfb1b,at&t,6786332861,143577324,55452,16328,6929981965,2022-10-31
8b016fcc09e97d1b,verizon ,325305623,42327546,814210,69241,368516620,2022-10-31
cc11ee7bf281fb6c,verizon ,872069818,67351434,943313,125205,940489770,2022-10-31
d508370196614f7d,at&t,436444275,13876740,104616,28528,450454159,2022-10-31
7858d22acf299306,t-mobile,526832023,31475399,1535860,148949,559992231,2022-10-31
14607ec0714788d7,at&t,1489083406,67585727,78856,23566,1556771555,2022-10-31
52f6e284bc7a609e,t-mobile,379667769,29744174,1309970,100290,410822203,2022-10-31
2cd1ef7a852f7cb1,t-mobile,373802575,25114282,0,0,398916857,2022-10-31
b13dfe89ae89d39e,mint,502766945,36689818,340412,96523,539893698,2022-10-31
0b13154a66c0ca0e,t-mobile,962090279,51847925,648433,386659,1014973296,2022-10-31
13a90e723c4aa2bd,t-mobile,1262072432,75675826,6694,2040,1337756992,2022-10-31
64f649029e98cb44,t-mobile,490124,51994,135989,41515,719622,2022-10-31
83cffffcb2fba7ac,mint,10029833855,43413038,1310901,367752,10074925546,2022-10-31
44570b2108d473f2,,1026139479,20245226,0,0,1046384705,2022-10-31
2105647ca37fd381,,343529490,31541221,15105,5399,375091215,2022-10-31
e4cb72c7869e4e4b,mint,130470764,2417650,1377362,92405,134358181,2022-10-31
7f9274cf3fa3c7f3,t-mobile,340754291,21426004,20006,5980,362206281,2022-10-31
e6dddb22061b32c9,t-mobile,0,0,770039,54602,824641,2022-10-31
28733009c01f6efe,t-mobile,0,0,2040188,294874,2335062,2022-10-31
40e5cb9ecd3caa3c,,147527304,1451521,0,0,148978825,2022-10-31
a57cff859438fa67,mint,213657496,16509709,1127468,189734,231484407,2022-10-31
e6c42916e7948c3c,mint,494685749,31163121,1155851,200081,527204802,2022-10-31
49a30c79330accc3,,594835825,8933144,0,0,603768969,2022-10-31
349e1ab9274b9099,mint,452842685,34963210,6935,2284,487815114,2022-10-31
e4c4082a4b91a8e0,mint,2894624252,31505271,1906287,274210,2928310020,2022-10-31
a2aab369ffa6914e,mint,442799457,39686912,34431068,1165626,518083063,2022-10-31
e6293cf2ca9e9512,,146813141,3578775,0,0,150391916,2022-10-31
fdd80ea0738c19da,mint,995132627,65784770,1949300,308266,1063174963,2022-10-31
7e60327302f02ba1,metro by t-mobile,7488,5250,757952,267895,1038585,2022-10-31
df322154996636b7,t-mobile,557214457,27935099,916449,137631,586203636,2022-10-31
98751a93371a7aae,,121588725,2138191,0,0,123726916,2022-10-31
89811ed9930204d4,mint,226900820,21332654,0,0,248233474,2022-10-31
210c7bf8bdaf791d,mint,501209279,8518043,25139,15732,509768193,2022-10-31
cfde29555c606d32,mint,308168319,16481377,1139789,223059,326012544,2022-10-31
99b8eff440e0e0aa,mint,496798344,38212785,3107,1539,535015775,2022-10-31
4e2de68fe785383f,mint,568956671,70392505,804734,99513,640253423,2022-10-31
ee382fe9782c67ba,,5312330,517758,0,0,5830088,2022-10-31
fc22bdb00893b165,,593,350,31632,123446,156021,2022-10-31
ff8f3feb2201814a,mint,42406,9346,0,0,51752,2022-10-31
0e6776d5f9f551e9,t-mobile,668246470,61322408,0,0,729568878,2022-10-31
22cb192ced19cce3,,146734296,1759208,0,0,148493504,2022-10-31
128cf533ece45fab,t-mobile,734889348,60558761,57341,20034,795525484,2022-10-31
a7138361c687e12a,t-mobile,1169653256,54395196,21152,5099,1224074703,2022-10-31
1369ae40c62ae716,,223916094,13806941,618548,43902,238385485,2022-10-31
1a271baeb30bdd04,mint,38866928,1290447,0,0,40157375,2022-10-31
b97d32d39089630e,,14112,2806,507993,591156,1116067,2022-10-31
7d10046aba144b44,mint,499936401,80685707,305922,112201,581040231,2022-10-31
8440a76c54299c33,mint,327541793,17536963,20615264,738870,366432890,2022-10-31
bc395b46a0301394,t-mobile,639366432,35350674,1642814,345173,676705093,2022-10-31
101e3836b2ebac61,mint,1033640529,56739422,1117503,210603,1091708057,2022-10-31
2c6a5a840987c410,t-mobile,381156997,22963509,678420,65467,404864393,2022-10-31
17b25480cd40947c,,109612942,1432025,0,0,111044967,2022-10-31
d2d3b827b1a104e4,mint,0,0,36672042,947958,37620000,2022-10-31
0ed4c73469297c2a,,2144635450,27277571,0,0,2171913021,2022-10-31
78092792c2010436,mint,1498446490,83946210,58789,19148,1582470637,2022-10-31
eadb117760da1d31,cricket,806926180,28568249,1904454,260443,837659326,2022-10-31
6a4e1aa07096b97c,at&t,360500275,19731617,99835,9999,380341726,2022-10-31
3d5934a3ae1be792,verizon ,245897583,28365330,6661,1637,274271211,2022-10-31
683778993c2dfabe,verizon ,600085242,52379145,6713,1848,652472948,2022-10-31
b19a2dfd8b9861cb,verizon ,636050042,69875351,2006644,275481,708207518,2022-10-31
afba0006a9b190d4,at&t,0,0,1553420,130326,1683746,2022-10-31
a9088bbae93b5a17,verizon ,653811560,45117364,15014,4042,698947980,2022-10-31
d50bafeb8bcc464a,xfinity mobile,2531673110,116323238,1568815,152904,2649718067,2022-10-31
88a23d30ec159297,at&t,0,0,2326396,389714,2716110,2022-10-31
3cdad01f022d66da,mint,1241875222,71204532,102948,33435,1313216137,2022-10-31
c41d264387972352,,276002171,6611254,0,0,282613425,2022-10-31
130d881e64dc7737,mint,5282886449,164934500,611303,6591,5448438843,2022-10-31
40f2f15bcbf023d3,,920145421,59848837,0,0,979994258,2022-10-31
7918e806411b925a,verizon ,928464413,30864825,1445107,279773,961054118,2022-10-31
5140dbfbb59f2162,t-mobile,1245953211,73384450,69536,20224,1319427421,2022-10-31
1f4121c4125196c4,at&t,749087149,50459282,1268712,92553,800907696,2022-10-31
c120c744df0c28e1,verizon ,407971592,41630576,301104,106240,450009512,2022-10-31
60a3215e2fcc1885,mint,1423345,269183,307,4360,1697195,2022-10-31
b163c0a0f26d7fd0,cricket,1154401558,101128486,647968,35516,1256213528,2022-10-31
aa4f752443036e0e,verizon ,922438089,48681349,1310228,70213,972499879,2022-10-31
397bb0ab22c5edcd,us  mobile,838848572,78972539,1049725,165069,919035905,2022-10-31
c4f3d710a084598a,at&t,287919696,31040110,369687,137438,319466931,2022-10-31
ef016fcd0e5448bf,mint,610651983,53798943,850973,88581,665390480,2022-10-31
1d09dc807796e0b9,verizon ,784734,215658,155750,52088,1208230,2022-10-31
46be2cb8e69b3fa5,at&t,617472551,44440513,1543114,311178,663767356,2022-10-31
78c95d2ef9f333a2,verizon ,673689894,54456426,1996240,280863,730423423,2022-10-31
4f4d54c2e695b1e0,Â ,316599947,6277351,1300327,61957,324239582,2022-10-31
953ae048fa551753,verizon ,314408660,21551600,84,84,335960428,2022-10-31
abed3b799a6ca50b,at&t,654825303,75758159,121669,41345,730746476,2022-10-31
ce08d1d651aa2527,verizon ,708454524,57090188,1520649,211181,767276542,2022-10-31
db5e71b1388c2d53,mint,802273279,37635684,156440,57645,840123048,2022-10-31
3c33af73e4980531,mint,1022122322,80676079,77528,28673,1102904602,2022-10-31
e33b8dcdb1e71173,verizon ,616872329,59537614,1369391,268824,678048158,2022-10-31
fe93eeb4780cfae4,mint,2116128613,49332882,0,1020,2165462515,2022-10-31
e3159345a5e6eaed,t-mobile,407821162,69742208,738993,64685,478367048,2022-10-31
ee2acf61b7f739ed,t-mobile,1031405309,65945177,1335702,96017,1098782205,2022-10-31
52ad5829c03b2b98,mint,1242475312,83607032,289344,118786,1326490474,2022-10-31
7356f0a9e42fd432,mint,792365355,13161152,6752,2020,805535279,2022-10-31
da079fba1c1cf233,mint,487031201,53357308,902159,158684,541449352,2022-10-31
db7ccafbdd43d132,mint,5261665692,140097957,7252,2359,5401773260,2022-10-31
5b7ca1e0943894ae,tello,115831068,14033871,0,0,129864939,2022-10-31
8dbf9702bbb1e4a1,mint,1929428178,83923904,949841,271207,2014573130,2022-10-31
99b35cfa2c23e958,mint,604792376,46002649,0,85,650795110,2022-10-31
764062ba379c402d,t-mobile,41183278,1088502,602,685,42273067,2022-10-31
d2ab28b422930602,t-mobile,261650198,6540874,0,65,268191137,2022-10-31
095353703a40df6c,verizon,288429966,5323734,0,0,293753700,2022-10-31
c66336cf1cf3d4d1,mint,653938860,9908611,0,0,663847471,2022-10-31
fca76ab95a357a86,mint,289906831,62813181,194537,76485,352991034,2022-10-31
fb73745c2e5cc925,mint,328049569,26961717,762734,135300,355909320,2022-10-31
fd012b1799a51d1b,,55630,13128,0,0,68758,2022-10-31
56625af4021ac0a3,mint,12562667,2429830,0,0,14992497,2022-10-31
7a560b529e7ca947,,105145503,2895219,0,0,108040722,2022-10-31
e5e3b913d67ae700,,129009668,3552449,0,0,132562117,2022-10-31
20233f1e3220b70d,,55853,123479,0,0,179332,2022-10-31
4a26c89b4d0314dc,mint,283780914,28533693,78513,27104,312420224,2022-10-31
7e4a1089b1fe93e8,verizon ,316791559,38029931,1318814,109400,356249704,2022-10-31
a0898292f9cb08c0,mint,91710649,5800798,658,3454,97515559,2022-10-31
8262d2539e7899c4,t-mobile,693014577,63517907,113250,19402,756665136,2022-10-31
b67d12d98866b7ec,,1109545816,36209590,1899,2782,1145760087,2022-10-31
180d764bc38eea52,,150091626,2986487,0,0,153078113,2022-10-31
fa2934e963180531,mint,3442398969,40195602,918966,72832,3483586369,2022-10-31
243028010bce498a,at&t,282515027,41752290,762314,69729,325099360,2022-10-31
306f236ed00b700d,mint,3856274628,115501860,1133557,193044,3973103089,2022-10-31
31f8c5df924fe477,at&t,1253633649,94625091,486732,86289,1348831761,2022-10-31
0606b08b81e2204f,,50266456,7849300,0,0,58115756,2022-10-31
49fc291c84968a7c,verizon ,0,0,21445508,1193138,22638646,2022-10-31
2913ee152223618d,verizon ,759139644,71145362,1770216,216449,832271671,2022-10-31
16603505b11d2494,verizon ,4204198093,71000266,1610617,94325,4276903301,2022-10-31
eab106629ed8daca,at&t,698106401,73320080,122057,42338,771590876,2022-10-31
01646e786810009d,mint,725007500,59052733,3165967,695163,787921363,2022-10-31
d1b0a212ee8391b9,verizon ,840329961,96231843,1222760,228319,938012883,2022-10-31
baad35c18609dd41,mint,126026038,2721813,0,0,128747851,2022-10-31
978d17f617c32a6b,t-mobile,873299978,34476862,686735,54329,908517904,2022-10-31
dc28814d8796f87a,mint,644749561,55530244,66122,22945,700368872,2022-10-31
905332212ad72086,t-mobile,573696157,47425211,6935,2140,621130443,2022-10-31
76d9ec153ade1a07,mint,0,0,1343141,102659,1445800,2022-10-31
7a0ee840af5eb7a5,at&t,801737108,48338180,34,69,850075391,2022-10-31
54e2c8b0b0d07427,mint,1087467559,47648188,921848,153335,1136190930,2022-10-31
953b9342a267f1ab,t-mobile,352549454,15330767,584040,182577,368646838,2022-10-31
554d671b4a537b18,at&t,51328873,5602133,42651,20396,56994053,2022-10-31
652dd401b526353d,mint,591062998,14754149,653106,25017,606495270,2022-10-31
846860d6a140bdec,,399830083,24075913,467483,37754,424411233,2022-10-31
9df8135ab67cf1b4,at&t,605858138,51096301,1320831,74375,658349645,2022-10-31
96ac2a6909fd5bde,,150231953,1626059,0,0,151858012,2022-10-31
56b5689764a7d4ef,at&t,572231757,39641165,6557,1951,611881430,2022-10-31
bda529c9d38b6f03,,369711629,43738432,1050218,80593,414580872,2022-10-31
7838a2d741508a0e,at&t,343099205,23450910,972645,235047,367757807,2022-10-31
e685122adb812f26,,549215873,5570444,0,0,554786317,2022-10-31
808077f99dd49f11,mint,764242996,62919155,28639,8526,827199316,2022-10-31
c7a47796f813a73e,mint,520693533,20865903,1356242,93950,543009628,2022-10-31
67326751937e72cd,mint,672130727,42523091,50785,191643,714896246,2022-10-31
1723ea11c0cad351,t-mobile,382754758,32327166,2005240,379682,417466846,2022-10-31
22eeddd4a344a050,,1344201496,26306428,0,340,1370508264,2022-10-31
6123d89b23863be4,mint,354848483,44289916,702650,59405,399900454,2022-10-31
38071ba665f5d287,t-mobile,921037499,59961730,1528484,143832,982671545,2022-10-31
f0d2a3ec9e9075ef,mint,413169431,26296181,33346,7178,439506136,2022-10-31
c1852c6891ee63bc,mint,419181347,11297693,6357,8826,430494223,2022-10-31
5096ce44d0d477b9,verizon ,783037158,63327175,6609,1563,846372505,2022-10-31
cfd1218b8fa2e046,us mobile,746949028,82360465,665322,83290,830058105,2022-10-31
77beece1cc4198b0,verizon wireless,579103585,59138292,1022205,162164,639426246,2022-10-31
7927bdc30a1ecd3a,,175755837,2553980,0,0,178309817,2022-10-31
f71ecea4e7236530,t-mobile,314237322,45819668,6672,1876,360065538,2022-10-31
2c272c72e4cd132d,,199277395,3929099,0,0,203206494,2022-10-31
cff62fffb7cbd134,at&t,184004130,24980716,839044,95117,209919007,2022-10-31
30e43ea84d8b6334,verizon ,695529921,61083657,54549,16062,756684189,2022-10-31
68a913b2837bb1b9,t-mobile,875855814,96800769,201729,37913,972896225,2022-10-31
e70be4d4a0d4a138,verizon ,650744833,72077567,1157401,208215,724188016,2022-10-31
63d90810f3a212b4,verizon ,634138550,69793888,643303,35785,704611526,2022-10-31
588eb5d6813c19ad,t-mobile,915593241,59629635,1885634,250800,977359310,2022-10-31
4f1d2cf949b5d8c5,at&t,21841083590,194982779,7716,13139,22036087224,2022-10-31
59709573338bea24,at&t,771257648,65952337,624798,46698,837881481,2022-10-31
0bd6d38e4a1ca782,verizon ,190461381,15200363,296095,82144,206039983,2022-10-31
d75e01829d12b456,verizon ,822535918,57379845,84,84,879915931,2022-10-31
e1d017fff51f1676,verizon ,0,0,1705709,295757,2001466,2022-10-31
242e68b5203f258c,verizon ,440913752,48964843,67364,26485,489972444,2022-10-31
95f4912861ce7e75,mint,854715852,71303278,6534,1545,926027209,2022-10-31
e724e2df02978bcd,t-mobile,926499723,70682085,173806,63255,997418869,2022-10-31
c3fd7044d4eaa41f,t-mobile,0,0,657888,35691,693579,2022-10-31
c5ccdaca8877e789,verizon ,377159112,3496011,1299441,60193,382014757,2022-10-31
487422b3b4c835b9,mint,995243248,50209349,183940,62686,1045699223,2022-10-31
6337a73cf51738a5,mint,2496440329,62418792,1018211,91559,2559968891,2022-10-31
bc35cdddbe12f86b,mint,887826221,54526390,10819,3368,942366798,2022-10-31
f841de47a4996854,,1471317519,20451190,0,0,1491768709,2022-10-31
1b97eb2387dd296a,mint,895097438,61921191,1806260,335001,959159890,2022-10-31
a86158ae067dd89a,at&t,1140628044,45994006,676691,35428,1187334169,2022-10-31
2021bcffc650e0cf,mint,1136810407,49816557,13070,9256,1186649290,2022-10-31
71a899000283c577,mint,265657938,30666774,37297,15557,296377566,2022-10-31
746d5ffb248c3572,mint,440887702,46329986,14759,5526,487237973,2022-10-31
377008fad7a9a84a,mint,856451856,55036376,14197,4580,911507009,2022-10-31
57500076febe7ad4,mint,497802275,35351669,1048852,223714,534426510,2022-10-31
fd12c303316e49d5,mint,1311663852,84359373,7225,5356,1396035806,2022-10-31
a16efc404619e4e2,red pocket,748064596,47535969,84,84,795600733,2022-10-31
3ff45a63df0e79a1,t-mobile,1054113948,60661732,112704,42731,1114931115,2022-10-31
3dd153b3a3d9738b,mint,974063516,22954856,896590,103259,998018221,2022-10-31
35efdc4486624f8b,t-mobile,0,0,1824148,233070,2057218,2022-10-31
3f9d171a4f809b9e,us  mobile,771924049,57045675,13322,3586,828986632,2022-10-31
b4eeb9beb11c5837,,921590079,68323416,2300,27009,989942804,2022-10-31
3082681373b2bd78,,209653848,8588660,55049,16046,218313603,2022-10-31
6505b4376f747fe7,t-mobile,768635365,65310475,0,0,833945840,2022-10-31
53808079360ed594,at&t,3349121676,78181374,20470913,616896,3448390859,2022-10-31
dbd4fcde49612cf7,mint,930973055,53241222,2547091,468284,987229652,2022-10-31
1e93f3a431e7cd9b,mint,809163720,56754641,702746,56397,866677504,2022-10-31
aad2b409b66fcaff,verizon ,415103100,60726463,1311576,237819,477378958,2022-10-31
1ac0946c22229506,mint,509585691,59068448,17738,9474,568681351,2022-10-31
dee40b31be4abe20,mint,565314628,53740287,2110015,462053,621626983,2022-10-31
d8d3f5eb17cc24e4,verizon ,1423572329,71603323,4845,1463,1495181960,2022-10-31
70fb6d64d61a3a69,,218102278,8953841,0,0,227056119,2022-10-31
b12b4af171ae0233,mint,719370866,66358224,956372,192373,786877835,2022-10-31
ec36e483b4de10f3,mint,2234172768,63529861,3004513,656799,2301363941,2022-10-31
ea6e6865c6abb689,mint,426951508,32213199,0,0,459164707,2022-10-31
d3af12b087b814b7,mint,845504461,62241555,663075,36601,908445692,2022-10-31
fa25c438ee6956ec,mint,1810260315,64393631,1321503,67725,1876043174,2022-10-31
527e209271422794,t-mobile,477231797,63332949,84,84,540564914,2022-10-31
08540c58244ad595,verizon ,263356220,6220780,1453497,328393,271358890,2022-10-31
b05739075b060d0e,verizon ,647638942,63257432,645962,50754,711593090,2022-10-31
554510d2f66c0180,verizon ,550383858,58809018,395395,140067,609728338,2022-10-31
10a7df8797192522,verizon ,566913157,73825450,636581,22777,641397965,2022-10-31
b29c72a12c3aac5b,,219513327,35535915,0,0,255049242,2022-10-31
44d6700a6b1487d0,,762839970,66629689,128319,93474,829691452,2022-10-31
001395a0dfdd18f5,verizon ,827466601,53358550,736392,56435,881617978,2022-10-31
9b89ea9a2489b3c4,cricket,954995559,73593820,2489370,1056977,1032135726,2022-10-31
17cf7fee19b16f1d,at&t,484396421,59701814,1864500,346312,546309047,2022-10-31
cbb09c676223a4f0,verizon ,472318978,54459389,665025,278109,527721501,2022-10-31
62cd0e441840877d,verizon ,554330182,53309723,134931,46264,607821100,2022-10-31
9de7a33a83157909,verizon ,530891634,72952910,737267,73161,604654972,2022-10-31
aab9c4a6cc7c1af1,t-mobile,700867894,66282364,73553,26650,767250461,2022-10-31
f4a7dde75b8f0223,verizon ,865941974,63192986,6558,1995,929143513,2022-10-31
c6d4b0a765ce3aca,,44835000,1098572,0,0,45933572,2022-10-31
de44f332142665e4,verizon ,688158354,56342534,658489,68321,745227698,2022-10-31
8200d312152bfab3,,160853641,4246191,0,0,165099832,2022-10-31
9761f90f6e393678,,101472241,3151434,0,0,104623675,2022-10-31
cc384c4387c41e2b,mint,852443947,62538248,7472,1974,914991641,2022-10-31
3595dece8aec3f2f,at&t,936488867,50155831,1330702,72666,988048066,2022-10-31
5d345c2afbea6d4f,mint,1215182945,58585565,132351,50705,1273951566,2022-10-31
0e5399b92dc001e1,mint,559206807,52949981,85371,30981,612273140,2022-10-31
c20e2ca63f5546a4,mint,518948046,49562795,7472,1654,568519967,2022-10-31
dc6e6457701ffe51,t-mobile,400233034,31172698,816690,88260,432310682,2022-10-31
66c6e971ca7fbf9e,t-mobile,1116283391,65501817,953465,137690,1182876363,2022-10-31
42a653aef2c20c8b,t-mobile,730571280,39164282,610799,59499,770405860,2022-10-31
7565df9cbd033b74,mint,2070639454,54306882,7153,2296,2124955785,2022-10-31
204de08cec94c1cf,mint,384463526,48655258,1670625,329929,435119338,2022-10-31
844510e2ffac9890,,467353182,27449226,0,0,494802408,2022-10-31
7d38ad1cb87fa65f,at&t,358752449,7918329,41944,18095,366730817,2022-10-31
d62f0b2dd067bab9,mint,753999270,20055277,7396,2479,774064422,2022-10-31
4d5d4638ae58747f,,149641838,2877653,0,0,152519491,2022-10-31
e9b4361d27b99a2c,mint,1991242014,38254075,151875,60121,2029708085,2022-10-31
2887d5772e8940e6,t-mobile,1123579890,12283811,1057073,177286,1137098060,2022-10-31
2ecaa6222093cafd,,125218053,3053615,0,0,128271668,2022-10-31
226f12ef25e94b11,,166814625,3096945,0,0,169911570,2022-10-31
174b27fc46ea7a04,mint,4778047559,103313404,22140,3901,4881387004,2022-10-31
c7bffab181b10d4c,t-mobile,1030863773,19339531,50318,13997,1050267619,2022-10-31
31415e8232232237,mint,554187952,8412804,537751,46794,563185301,2022-10-31
a2e1f12af3492a98,pure talk,925072483,26396929,1277441,196658,952943511,2022-10-31
9461079f6e4b74ec,,262819995,4917484,0,0,267737479,2022-10-31
db6b86df0d7ac3de,verizon ,502638251,67757278,199552,68126,570663207,2022-10-31
a0c721c4f4d425e1,at&t,674427313,44938458,1365671,292327,721023769,2022-10-31
b01db27642964ffd,,157199232,1180574,0,0,158379806,2022-10-31
673b2f13ab9e1087,verizon ,1048728917,75566226,1211762,232450,1125739355,2022-10-31
11e9018b439d9fff,verizon ,356913960,62519208,1364323,257038,421054529,2022-10-31
317fd8b0962da23f,Â ,475575695,56393343,1314714,75284,533359036,2022-10-31
0ca6618ace625aa8,verizon ,2063378470,62472311,588105,26369,2126465255,2022-10-31
4dbfa46019b5d54a,verizon ,808359976,9176165,2032669,291910,819860720,2022-10-31
0e302dcfc04267e1,verizon ,686183249,82383249,6574,1741,768574813,2022-10-31
a15430412e84c8dd,mint,1148035568,53364447,622449,13715,1202036179,2022-10-31
ebe40c334fd20931,verizon ,1087890089,54527913,299940,100743,1142818685,2022-10-31
bea1c5b4ed2f47d6,,318257911,15518881,0,0,333776792,2022-10-31
7631c1a8dc117163,t-mobile,208182042,2567632,1226232,65936,212041842,2022-10-31
bc77b193b36ee417,t-mobile,563637097,35465943,102636,29010,599234686,2022-10-31
4db06e7f534afa47,mint,2001690379,26803788,23516,180776,2028698459,2022-10-31
8677e34d49dd9c23,,40643270,727828,0,0,41371098,2022-10-31
5514a36440ca6ead,mint,336077621,19178391,0,170,355256182,2022-10-31
bda652515f4b3b7c,red pocket,1438865409,48479502,125,233,1487345269,2022-10-31
6388f3cd8921146d,t-mobile,5421889004,70764184,277589,93057,5493023834,2022-10-31
e1e044a0f19a22e5,,159004322,2791127,0,0,161795449,2022-10-31
87bc4bf221b543c8,,52611481,1036224,0,0,53647705,2022-10-31
6b45b981a8e2dc4e,,83988678,2034015,0,0,86022693,2022-10-31
252559202237f734,verizon ,1199401198,84470440,1298135,68462,1285238235,2022-10-31
b92450ba76dc925d,,205616585,17360143,0,0,222976728,2022-10-31
18cba9153160926e,mint,1148999452,33968430,13416,151109,1183132407,2022-10-31
3f8499448bf481f6,,86965537,2886223,0,0,89851760,2022-10-31
e6cf3cb0fdf871a4,mint,1315218622,19596100,14442,4688,1334833852,2022-10-31
ac43b754c047e8c4,,804569366,35411501,962893,147032,841090792,2022-10-31
3216bc26e22c2d71,spectrum,292694251,9037729,662737,221643,302616360,2022-10-31
e220feb71568a4d8,mint,4624162409,75755455,1410817,288442,4701617123,2022-10-31
4706c19cb96ee7d1,,115209357,1480863,0,0,116690220,2022-10-31
757a19c10362734a,,155578222,1960012,0,0,157538234,2022-10-31
50569309a7c6d952,,154781845,992699,0,0,155774544,2022-10-31
bba81e1ab77179b1,,154368988,1847610,0,0,156216598,2022-10-31
41989b3ad7c77099,,154741649,1178173,0,0,155919822,2022-10-31
9e007eeb3f3d90c8,,154573236,2081340,0,0,156654576,2022-10-31
0e86030bdfc3bcef,,154184431,3030027,0,0,157214458,2022-10-31
9fd3f60b626f52bb,,164005941,3447964,0,0,167453905,2022-10-31
cf422119701db10b,,154317771,1807585,0,0,156125356,2022-10-31
501b51e6585946d8,,154583711,1993330,0,0,156577041,2022-10-31
7778be89840d8eff,,154509435,1904425,0,0,156413860,2022-10-31
9b2ab34790cba541,,154439227,2138832,0,0,156578059,2022-10-31
818f104993dedf05,,1940804628,49800053,175067,65418,1990845166,2022-10-31
08e1d5471e5d7f57,verizon ,1052744009,22823713,0,0,1075567722,2022-10-31
1140254eb4c9cec8,,409000600,9409148,0,0,418409748,2022-10-31
1eebdf391a187802,t-mobile,906433370,26026819,927605,120728,933508522,2022-10-31
4616eb5b178363ba,verizon wireless,353879207,14488725,37420169,1073431,406861532,2022-10-31
90a6d84f981c99cd,,182526600,5083547,0,0,187610147,2022-10-31
eaad898745ee3c97,verizon ,3447589429,38094420,12100,7769,3485703718,2022-10-31
8f9a3310130a777c,,176137029,5790368,0,0,181927397,2022-10-31
7b70d78bb6667b53,,82996146,1841470,0,0,84837616,2022-10-31
53c66debef8c937c,,78160539,1845195,0,0,80005734,2022-10-31
4ca3bcef53f39736,,69652473,1546870,0,0,71199343,2022-10-31
e7005c265055acae,,78825660,2114254,0,0,80939914,2022-10-31
b98146b16b37df0b,mint,2436805415,19614955,63641,150502,2456634513,2022-10-31
d4ee70ea414ac827,verizon ,262035057,4551469,0,0,266586526,2022-10-31
28faccb5c9b7f68c,,165831262,4556505,0,0,170387767,2022-10-31
22113c50c509a4d2,,106756452,3705120,0,0,110461572,2022-10-31
2f653d25ea45789b,mint,1448593593,44251531,1575954,328975,1494750053,2022-10-31
2024af9ebd5fe104,,214366692,2875683,0,0,217242375,2022-10-31
1285e1ec8eb675e0,,64495090,2591208,0,0,67086298,2022-10-31
9cec576827077c82,,88099,2712,0,0,90811,2022-10-31
ecfde15a879c2ca6,,293067848,3807823,0,0,296875671,2022-10-31
aef941e97e7690b3,t-mobile,0,0,644502018,5654609,650156627,2022-11-30
f74a7430b365a949,t-mobile,200234205,4226116,0,0,204460321,2022-11-30
102055452969904a,t-mobile,0,0,0,0,0,2022-11-30
4540a9d697479f12,,777851,227822,0,0,1005673,2022-11-30
786a9f59be5bcaf2,,48145375,14829946,0,0,62975321,2022-11-30
a6b124230da49673,t-mobile,0,0,0,0,0,2022-11-30
22a0b810804657d9,verizon ,0,0,0,0,0,2022-11-30
db6e21dd6d0e1f87,,719365234,16613509,0,0,735978743,2022-11-30
9f29a370a7e39946,,12459648061,263181839,727242,126409,12723683551,2022-11-30
98c3a9d74d623e0e,verizon ,25111914749,445692914,685316,38709,25558331688,2022-11-30
f788640b075aa01f,t-mobile,0,0,0,0,0,2022-11-30
fffd37727f5d211e,t-mobile,270471,71409,424484,130113,896477,2022-11-30
df7eaec7c96bdb76,,414441360,7656618,0,0,422097978,2022-11-30
a783e564a94635e6,t-mobile,0,0,0,0,0,2022-11-30
c391bd2c3e58917a,t-mobile,0,0,266499299,7059324,273558623,2022-11-30
5a4e723bb3623958,,745900,209525,0,0,955425,2022-11-30
a40221fc87e2bf58,,25330020,729846,298,8786,26068950,2022-11-30
70e822b93fb9297b,,119143875,18187887,0,0,137331762,2022-11-30
8388ec0e8f27d672,,330525978,5588819,0,0,336114797,2022-11-30
6a7935a6ed4c2a06,t-mobile,0,0,0,0,0,2022-11-30
afe58ded26003070,t-mobile,454175728,20096521,89353,32332,474393934,2022-11-30
b7719cfdabac5bf9,t-mobile,0,0,0,0,0,2022-11-30
e6372ee8a7c36bd2,,554446,197021,0,0,751467,2022-11-30
8c30d62918173b27,,823239,277102,424253,159907,1684501,2022-11-30
13d660c974a18c6f,t-mobile,0,0,0,0,0,2022-10-31
474c34b42ff114d9,verizon,0,0,0,0,0,2022-10-31
5b3fae7c218f230c,,811760144,12557432,0,0,824317576,2022-10-31
ea5e716ac0f1d060,t-mobile,655100480,51505032,104,104,706605720,2022-10-31
bff6f018205684a0,verizon ,712506,471636,920525,327106,2431773,2022-10-31
00683ae73ccad0bf,at&t,0,0,0,0,0,2022-10-31
ddee5db850a34018,verizon wireless,0,0,0,0,0,2022-10-31
930f9b1abc4b74cc,verizon ,11696182276,286186115,871470,128607,11983368468,2022-10-31
e5254466b5ed8efb,verizon ,142685478,2397295,1001410,377179,146461362,2022-10-31
12b33f587711730a,,732941,266262,0,0,999203,2022-10-31
375dea0cc7cdaadd,at&t,0,0,0,0,0,2022-10-31
a078440c3464d3b5,t-mobile,112642633,1129291,821017,269172,114862113,2022-10-31
fd2cb71dd756a393,home,9384906285,200280954,0,0,9585187239,2022-10-31
f11a60f3b4ea7fd2,,273339855,5327518,0,0,278667373,2022-10-31
69899a9f5eb9f3b1,t-mobile,1025618730,17828600,0,624,1043447954,2022-10-31
fce7d81ddb932628,t-mobile,0,0,0,0,0,2022-10-31
aec13b487a18719a,at&t,0,0,0,0,0,2022-10-31
2bc67f7810c575fd,,1549012766,24209590,23420591,1380793,1598023740,2022-10-31
b19fc7a7c2e40e3b,t-mobile,0,0,0,0,0,2022-10-31
340285d23f43f480,t-mobile,377941139,16637293,1400300,284970,396263702,2022-10-31
f07aa10dbe382d6c,t-mobile,124840,44846,69636,15250,254572,2022-10-31
6c12129d9c4f022a,t-mobile,17758408245,372122113,233758,93257,18130857373,2022-10-31
de9ee8c9321c937f,t-mobile,94242264,5543892,1056122,180196,101022474,2022-10-31
5c9063218bc5a4eb,,92333,922357,0,0,1014690,2022-10-31
c0f5e9e8cddc4780,cricket,677783731,11854406,0,0,689638137,2022-10-31
018f19952cef3426,metro by t-mobile,705872596,52548540,24218,117242,758562596,2022-10-31
1c337d334ee5430e,at&t,831856,301294,0,0,1133150,2022-10-31
cc93fe0d653c667a,t-mobile,0,0,0,0,0,2022-10-31
dd887c33505229f6,t-mobile,4779918955,112668246,38553,14629,4892640383,2022-10-31
e9ced1f0b6fd6751,t-mobile,0,0,200709,70615,271324,2022-10-31
3e0c57ff528fa826,t-mobile,0,0,0,0,0,2022-10-31
589345b24e7a4607,t-mobile,0,0,0,0,0,2022-10-31
b1017e3e389908d6,t-mobile,0,0,152581265,2702961,155284226,2022-10-31
d4c372c0786dc7c1,t-mobile,802757,221604,190339,73547,1288247,2022-10-31
19427c8aecb4dd46,t-mobile,693255,324988,169085,39000,1226328,2022-10-31
0399723d627dc2d4,t-mobile,164268755,4145034,11514,126364,168551667,2022-10-31
88da7b1bb881564a,t-mobile,460447756,36914734,33246,8147,497403883,2022-10-31
b6d54b30a4aa5840,,22214,8901,0,0,31115,2022-10-31
795dc89931ae1ad9,t-mobile,0,0,0,0,0,2022-10-31
6ee4f074bd00cc98,,659940279,92347646,806380,142602,753236907,2022-10-31
c8cc2bfb34a8c694,verizon wireless,0,0,0,0,0,2022-10-31
f59bc318ba2e3df5,verizon,0,0,0,0,0,2022-10-31
cc72f4c0362edb67,t-mobile,0,0,0,0,0,2022-10-31
6de0039c5bd996dc,t-mobile,629154153,78759516,6737,2271,707922677,2022-10-31
489ae8ad07efb372,verizon ,29496524518,520123743,687509,47603,30017383373,2022-10-31
a1f6921bb25392f8,Verizon ,739806331,21142522,618394,26253,761593500,2022-10-31
0cc155bd08051df7,,29756,202898,0,0,232654,2022-10-31
7108e796b6044ca8,,397183324,6649526,0,0,403832850,2022-10-31
ea636fd60016383d,ting,0,0,0,0,0,2022-10-31
79735fcdd62de954,,790370,258080,348420,129707,1526577,2022-10-31
2f0899f06c12ccf1,t-mobile,859734,269979,0,0,1129713,2022-10-31
3390fbdaaa1a35bc,smart,6092287,1037202,0,0,7129489,2022-10-31
92d59425eabebf02,,86211272,11879882,0,0,98091154,2022-10-31
fcf4c65e582819bf,,118944763,2030406,0,0,120975169,2022-10-31
ecd2affc2eccf568,,144990,38700,7007,1866,192563,2022-10-31
0b934d82b333df26,mint,845953231,71408741,1300949,91632,918754553,2022-10-31
76996ed17c7ddeaf,t-mobile,0,0,792416,99835,892251,2022-10-31
dcac0727217b38eb,verizon ,304585199,6139038,13396212,610757,324731206,2022-10-31
2ed648d48ce3f0ae,,725185664,12768904,0,0,737954568,2022-10-31
e50b9a6cfed0e05b,t-mobile,1249050136,85759371,1001310,178629,1335989446,2022-10-31
738bdda780fba7ed,verizon ,625757053,28919427,77488,33187,654787155,2022-10-31
4e959746f82d4342,t-mobile,346440323,5585230,984,10609,352037146,2022-10-31
1a15bd599e7961ce,,775588,223161,0,0,998749,2022-10-31
a4b5c1750803d8bf,t-mobile,130955750,5758843,739176,107453,137561222,2022-10-31
b9d95a0dc0959a43,t-mobile,694237,261712,0,0,955949,2022-10-31
da49b8e428e3d45d,verizon ,169147354,3129383,68598,27289,172372624,2022-10-31
cbc3a1cdb5acdb22,t-mobile,0,0,0,0,0,2022-10-31
2cebc153fc856b06,t-mobile,3142512395,117731484,238611,89350,3260571840,2022-10-31
5eeeac26dca28bd2,,337079,119425,884504,309805,1650813,2022-10-31
6a24c41339157d6b,,865561,229964,0,0,1095525,2022-10-31
0557c0721ff5403b,verizon ,672660170,78143872,54816,18248,750877106,2022-10-31
4efcdf3051f2520c,,6389723332,150335271,728068,123236,6540909907,2022-10-31
6797c5c120f3ee04,t-mobile,0,0,0,0,0,2022-10-31
41a83c279e36aee1,mint,709463,234229,23439,8899,976030,2022-10-31
78e62e0f4b7e0bfa,t-mobile,209604,73544,400201,146355,829704,2022-10-31
364138d169a0b303,t-mobile,56430278,1276567,0,0,57706845,2022-10-31
4abba56a75b7af16,verizon ,0,0,164309801,2932513,167242314,2022-10-31
ac24a97ec27a8cff,verizon ,295480441,35561534,247350,80548,331369873,2022-10-31
ba1920510bf9404b,verizon ,463343279,69001570,741690,55347,533141886,2022-10-31
c460bcdd57feffa4,,6515,21133,0,0,27648,2022-10-31
b53e1683e6846eda,,176519,62032,0,0,238551,2022-10-31
c0b8ebd6e9ef8414,at&t,577007,169942,32179,10693,789821,2022-10-31
8739c0024a46ec37,t-mobile,27170,11941,0,0,39111,2022-10-31
23021cdb5cd87766,at&t,0,0,0,0,0,2022-10-31
e2ce165f8932f016,t-mobile,16854124,473893,69961451,1819015,89108483,2022-10-31
d4b3e7de04e7fd47,mint,15382,18786,697103,279553,1010824,2022-10-31
47245871f1c69628,mint,100612566,4419620,0,0,105032186,2022-10-31
f4017a74c31c94ee,ting,401399523,33121325,83388,29963,434634199,2022-10-31
76588d5571a03b2c,,998956,398740,144771,55193,1597660,2022-10-31
9a3db9073c03ecfa,verizon ,1028338811,54753454,0,254,1083092519,2022-10-31
afa39bbf6e52d676,verizon ,11778133222,241046515,178561,59848,12019418146,2022-10-31
737a622a26837938,,39571,9517,0,0,49088,2022-10-31
5e5e29ca8bfaa73b,pure talk,615087,173054,0,0,788141,2022-10-31
ab4096aa69c42c34,,25648381,474806,19885967,685307,46694461,2022-10-31
f3f3f417dde961ff,verizon ,303743036,4315539,2679984,390487,311129046,2022-10-31
2959a0978429be69,t-mobile,788980296,23280052,373135,141376,812774859,2022-10-31
51afa4204e44e5a4,t-mobile,84,84,0,0,168,2022-10-31
f5675ae0115b4e3f,t-mobile,869422,286646,567190,210479,1933737,2022-10-31
b4b34e22735887ab,verizon ,2770433180,73823968,1388179,482556,2846127883,2022-10-31
a1bd98b00cda4cf5,,982585640,40194766,0,0,1022780406,2022-10-31
4e5449cc0edbdd66,mint,16749,7771,0,0,24520,2022-10-31
7341f741f0df8448,,212950,56888,94221,48982,413041,2022-10-31
f8689d452460e08d,t-mobile,0,0,0,0,0,2022-10-31
3be194613b74dc86,verizon ,0,0,6278940,147701,6426641,2022-10-31
222f7a7806e09341,,310635,101671,25319996,1184906,26917208,2022-10-31
15dcc4ae5076f5ab,t-mobile,58250569,1406979,688,12418,59670654,2022-10-31
d8afa85ac8b9ca3b,t-mobile,360693505,4260528,0,0,364954033,2022-10-31
cd562983f0cc90a2,t-mobile,53118,12260,0,0,65378,2022-10-31
4e8fd40de92e1c50,,148369947,2808855,0,0,151178802,2022-10-31
8ebabe027e17895c,t-mobile,56169108,764724,0,0,56933832,2022-10-31
3b91cde11b5a503a,,919789,322119,0,0,1241908,2022-10-31
28cc5b2c2f5b976b,mint,7711688263,161396002,106314,36504,7873227083,2022-10-31
5e33ea1df0344dfe,,112581207,1624697,0,0,114205904,2022-10-31
5e8e8715e46fe660,verizon ,643196137,10615755,8812,2148,653822852,2022-10-31
b9a3a9910d782693,t-mobile,152575912,2081005,8961525,351464,163969906,2022-10-31
bd7b34d36d74d128,t-mobile,2237362124,98840453,0,0,2336202577,2022-10-31
7226aebd9de0e335,,618244672,15947661,0,0,634192333,2022-10-31
35790e2191b8b603,mint,75879343,1811839,837368,118951,78647501,2022-10-31
4674f95ac22d6c99,,103682981,1760807,0,0,105443788,2022-10-31
58f0327e4164a498,mint,0,0,150820,46269,197089,2022-10-31
1256f7276a4d2b2c,verizon ,13455936678,242310287,956298,134129,13699337392,2022-10-31
67eae5ab453b5331,verizon ,550970684,10423366,2178068,543404,564115522,2022-10-31
bb25c3a36476e8b5,mint,0,0,814975,105136,920111,2022-10-31
0ef453d539d4a223,t-mobile,274841111,6685366,105325,33758,281665560,2022-10-31
b8e51dc7916f80f5,,232094765,21564722,814593,133161,254607241,2022-10-31
884b3dace35e1353,t-mobile,853209327,17688492,15590,3888,870917297,2022-10-31
75add81d50375d9f,t-mobile,232562036,5271419,578511,171224,238583190,2022-10-31
ce75f5bd587aebfd,mint,510418442,54402826,745359,58288,565624915,2022-10-31
cc98669da57a5632,t-mobile,354761565,24351727,53761,14082,379181135,2022-10-31
5309a8f94dd49091,verizon ,4956249922,74426110,2447,13417,5030691896,2022-10-31
b9723deaf5c3c15c,mint,102599,132207,177991,74083,486880,2022-10-31
4540ac515718714d,home,0,0,138897,51851,190748,2022-10-31
e711aa2ff014657b,mint,0,0,228549264,4456041,233005305,2022-10-31
59bf229397bae7ab,mint,926758739,39702796,710035,192779,967364349,2022-10-31
2de49466093402df,cc network,563183552,61704083,382871,31980,625302486,2022-10-31
0c56ae5b638e75d4,t-mobile,0,0,1153661,217041,1370702,2022-10-31
2339243e1548f65b,t-mobile,8084814782,157485028,1931169,300701,8244531680,2022-10-31
d7c07fee3f872463,t-mobile,540387017,52746426,1125669,211846,594470958,2022-10-31
74af7e21b6a5e072,t-mobile,165200329,923576,0,0,166123905,2022-10-31
a19774145937012b,mint,322988071,34768327,51872,17919,357826189,2022-10-31
bb55038c568a0670,mint,786497,221209,7079,1866,1016651,2022-10-31
ed208b50b84be2c2,mint,3394088505,103202329,0,0,3497290834,2022-10-31
1709e90d73ff748c,,341537170,4895410,0,0,346432580,2022-10-31
52d54b434c90ac75,mint,1955436,36008,0,0,1991444,2022-10-31
4d951f71483fedef,verizon ,14431160985,261539126,54297,16196,14692770604,2022-10-31
6a2dda22ad72c996,t-mobile,132573980,2949420,389738,141877,136055015,2022-10-31
4ae737778bb8b000,t-mobile,341590709,5940655,84,84,347531532,2022-10-31
501e32fa40dd156b,,2792607483,45708017,0,0,2838315500,2022-10-31
4bdcaba50cba0dc6,verizon,247345936,14309066,0,85,261655087,2022-10-31
7a81dfa1af656eab,mint,347598600,21465097,201,83,369063981,2022-10-31
770aa4d4a49f2123,verizon ,13257865814,258734176,625732,20881,13517246603,2022-10-31
fa2532f7a971569e,mint,662950163,54157387,985809,171450,718264809,2022-10-31
dc56ba6a0e9985c0,,154733363,3304628,0,0,158037991,2022-10-31
5016a41e9944cc64,mint,266218122,4980681,0,0,271198803,2022-10-31
6e2d79705c5b118d,mint,87612,30471,0,0,118083,2022-10-31
8e1d3021ba807240,cc network,647333984,65265819,694564,45324,713339691,2022-10-31
9240b45bd3f84b48,mint,812901,211389,0,0,1024290,2022-10-31
e9e491c697c37a5e,t-mobile,249903,186310,183956,60189,680358,2022-10-31
8eaf83bfe4027ddf,t-mobile,490188897,27105034,0,0,517293931,2022-10-31
427cb2b1ebf55c1e,mint,807630,247441,7532,1948,1064551,2022-10-31
fca9ed9159db2545,t-mobile,704481,190238,80589,10636,985944,2022-10-31
32e70273f516f78c,t-mobile,219332394,9784273,7019,2035,229125721,2022-10-31
d976eeb4c087a7ac,,542550659,8103086,0,189,550653934,2022-10-31
b2164f14d9e72e60,mint,1062634299,32354443,2007894,340974,1097337610,2022-10-31
89f1c484551332df,,703683,186423,121402,38412,1049920,2022-10-31
c358b29feb1c6196,mint,869592,289578,41502,14095,1214767,2022-10-31
8cd0a80b21503d96,mint,249328,73769,101342,36416,460855,2022-10-31
84392cc5a219c1fd,t-mobile,1169099166,62347513,14095,2435,1231463209,2022-10-31
059381c3ea52ebda,mint,730483392,17454941,0,0,747938333,2022-10-31
a7ab9232c0d7f1ff,,206595,164576,0,0,371171,2022-10-31
80c7cbc49d17502d,,815225,248437,15136,3896,1082694,2022-10-31
d115c3d246ab5de9,mint,776240117,53479087,0,0,829719204,2022-10-31
ee40d9ad0be3d276,,180856,275564,119507,150321,726248,2022-10-31
28f06ab847595f87,,11809,59877,0,0,71686,2022-10-31
8c3bc0e8f273a2e1,mint,271461,78801,0,0,350262,2022-10-31
4ed427d279d36325,t-mobile,570346134,41191082,67507,21275,611625998,2022-10-31
a6f8303df13728dc,t-mobile,435048,31254,645033,119282,1230617,2022-10-31
c668f6381961537c,t-mobile,740270,241005,208851,58571,1248697,2022-10-31
4c8899f93b6ef552,t-mobile,0,0,1240748,238416,1479164,2022-10-31
d7c86cf5d3ad81a1,mint,589093812,25093873,6410,1863,614195958,2022-10-31
e61447054abca5df,wireless,1370,84776,8997,5624,100767,2022-10-31
c988889330da8f95,mint,23536070432,327614368,4246,19902,23863708948,2022-10-31
04fc8fe7121fec01,mint,1106385236,137564425,0,0,1243949661,2022-10-31
056d3e26aa10df86,t-mobile,483765917,14947457,28589,13601,498755564,2022-10-31
d8b13b1cea566016,t-mobile,471239,153585,563633,155817,1344274,2022-10-31
46c35eb331961dd8,t-mobile,3666598144,95042940,0,170,3761641254,2022-10-31
1d70fd23ec3cb1e9,,309264007,11016670,0,0,320280677,2022-10-31
0a9d365f1b22be5c,mint,765847,241212,28306,9488,1044853,2022-10-31
31c09a960a21b5df,mint,408816,115177,662574,217662,1404229,2022-10-31
f4ef40e80485411a,mint,1177896610,19821919,33727574,566339,1232012442,2022-10-31
501058031de4930c,t-mobile,3423801427,105666479,44720,18266,3529530892,2022-10-31
8d0e8ea80a7ae2c9,,7489769,1511017,676289,255362,9932437,2022-10-31
1835aafc87fc24d5,,134739176,4666747,0,0,139405923,2022-10-31
c74a2b86c91c8b73,t-mobile,417071962,33360177,6565,1948,450440652,2022-10-31
7c9a12e6391094a9,mint,611295,149123,28847,20234,809499,2022-10-31
730f025c8414dada,mint,697781136,11466757,227,405,709248525,2022-10-31
c341915970a6df34,t-mobile,6477734,874355,0,0,7352089,2022-10-31
a92ada4d9146debb,,606029,191425,46691,13975,858120,2022-10-31
ec112a7a0b2675e1,mint,562411207,52973487,95145,35866,615515705,2022-10-31
a0ecc05b55105724,t-mobile,190450626,3998649,684987,49984,195184246,2022-10-31
aa228790a7a77233,t-mobile,616795608,61755592,646048,32419,679229667,2022-10-31
631505a877d2cabf,t-mobile,439713429,32530481,436,4225,472248571,2022-10-31
05a5d37e1b46b102,mint,428625943,18580076,1212044,240029,448658092,2022-10-31
9ec7995cbb7a3f84,,480298393,11166211,0,0,491464604,2022-10-31
a887699dfefadcc1,mint,587799502,39126799,694876,63777,627684954,2022-10-31
0e092d9e40e27086,mint,9010168806,161068229,36617,9005,9171282657,2022-10-31
d65062f76801ca8c,mint,456952,125874,35005,8166,625997,2022-10-31
24e5732fdd106f3b,mint,47658609,856907,0,0,48515516,2022-10-31
7cf693568e07d448,mint,132447562,3096418,0,0,135543980,2022-10-31
c65a61ce1466d06e,at&t,823896,291866,19427,5720,1140909,2022-10-31
fc2d144420001673,mint,53001725,1632048,0,0,54633773,2022-10-31
3bfbd1f3968112d6,mint,1971240079,39077869,7539,2087,2010327574,2022-10-31
d7a0e777a9e31233,,125497568,2004724,2280,35668,127540240,2022-10-31
91f34ad5bc0f42cd,mint,910046359,50547937,448666,164600,961207562,2022-10-31
cc8844ba79248e13,t-mobile,302133578,37357795,21836001,1210703,362538077,2022-10-31
c86ff2f4b9af7c04,mint,534038039,61093395,3194,1412,595136040,2022-10-31
f4233e5bc5616b0e,mint,703478018,44370205,93,166,747848482,2022-10-31
9ccc8178d2d66e86,t-mobile,954495719,63455650,0,61,1017951430,2022-10-31
b4425e41571e54b5,t-mobile,751365039,80610351,35579,12054,832023023,2022-10-31
a2d31208267910fd,mint,978715,279890,0,0,1258605,2022-10-31
f4fe2c566a2efc67,t-mobile,140004659,4202758,39674,11433,144258524,2022-10-31
7bc4bc1f85e6d5e3,mint,49555430,392533,7017,2577,49957557,2022-10-31
2c2d2af1d2ddaadd,t-mobile,3548774624,110361151,6935,2284,3659144994,2022-10-31
fdc5b411c87cb2de,,553795373,56250301,0,0,610045674,2022-10-31
280d0944ccaee085,mint,0,0,25460,10622,36082,2022-10-31
6cb82c842896af82,mint,4046680951,95365146,1307262,96724,4143450083,2022-10-31
f584583d8c486910,mint,382280998,42097203,20912,6913,424406026,2022-10-31
97dce61b39cccc45,mint,828421,278627,152334,42488,1301870,2022-10-31
16d61d76c8d181a0,t-mobile,687922225,21744374,578,5021,709672198,2022-10-31
f4d8a733e0667440,,547682990,10011417,0,0,557694407,2022-10-31
cc2679caf65d0fb1,verizon ,1366079406,94734954,50335,20450,1460885145,2022-10-31
e90281d4b143961c,,34342,7619,84,84,42129,2022-10-31
4ce240a69a4642b8,verizon ,2876565450,114596353,663272,72391,2991897466,2022-10-31
bbb56cb3757d1647,at&t,2102897531,92583039,656688,33164,2196170422,2022-10-31
48a3b9276b632142,verizon ,3235771212,73449410,38395,12428,3309271445,2022-10-31
07b8a225196b06b3,,20939,7143,0,0,28082,2022-10-31
2ec704bce6d447cb,extended,898442216,82079885,105438,42480,980670019,2022-10-31
3afcaff135849b16,mint,522516291,36515457,20133,116232,559168113,2022-10-31
349e0155f70373ae,,673403324,57951941,116537,47506,731519308,2022-10-31
fb09e7b9333c80fc,verizon ,573288541,31566512,733267,42780,605631100,2022-10-31
a43e0e39f6efbaab,verizon ,758501430,70424637,794912,72233,829793212,2022-10-31
9b382b6c308d0c9a,telus,583645368,59833852,6367,2915,643488502,2022-10-31
4cf368fd4e9d511d,at&t,260471509,28858281,2242394,376023,291948207,2022-10-31
b07430eca41daad4,t-mobile,632967923,10483314,2786642,596511,646834390,2022-10-31
346eb2903f91b4d9,,149811202,1238370,0,0,151049572,2022-10-31
f204609ac4ef2c1b,verizon ,0,0,1830064,273294,2103358,2022-10-31
834c6b79ece08d06,,776500,193027,160681,43551,1173759,2022-10-31
f8e771c752bea720,verizon ,781989,248008,234982,70993,1335972,2022-10-31
8709d57aa31400ef,cricket,849781980,73130517,0,0,922912497,2022-10-31
620a5db9a0e75bef,verizon ,1980436131,88008113,1322127,127494,2069893865,2022-10-31
9919b70b6f200e56,mint,574395248,75296981,80104,28649,649800982,2022-10-31
da1f8a4ed3689b42,verizon ,586724178,86242188,15148,4868,672986382,2022-10-31
d36d402ad62b1c31,telus,725240116,60565175,1926903,256055,787988249,2022-10-31
53592864ca369cf5,mint,503827781,52875552,908722,155959,557768014,2022-10-31
962e5eab3f000546,,220786748,5445399,0,0,226232147,2022-10-31
9bfafb4c828bc2a0,at&t,472510084,17771965,3114002,497704,493893755,2022-10-31
e7e142fc32f0369a,verizon ,1053174069,57868691,347512,113758,1111504030,2022-10-31
f120c704455b3ff5,mint,527222868,40928674,691260,442057,569284859,2022-10-31
f598c68ec123f5fd,mint,105292384,3851656,13580,2030,109159650,2022-10-31
e2b8e89aa3bf6366,mint,38083344,4760651,768706,146294,43758995,2022-10-31
a8f92b20f27f44e7,,375889080,27363485,0,0,403252565,2022-10-31
e26094092ce112f7,mint,302720996,9570965,827626,107154,313226741,2022-10-31
4496731e6ff410f6,u.s.cellular,1081182051,96315440,0,0,1177497491,2022-10-31
9886afd5b438c873,mint,241286469,22732437,6886,2116,264027908,2022-10-31
7c2ad201a3ec5a82,mint,900574451,55214441,1668641,330482,957788015,2022-10-31
2fe437a081d2fa78,,1367479930,28232513,0,152,1395712595,2022-10-31
07204f4540246c8f,,918354,181297,0,0,1099651,2022-10-31
87475a9381a7fda8,,219379749,4708642,0,0,224088391,2022-10-31
2e174ee1f5182597,mint,490604923,52616512,28493,107910,543357838,2022-10-31
18ff5571ad6b4540,700 mhz public safety broadband,358742182,7985053,0,0,366727235,2022-10-31
ef7c6bcdf961bae2,t-mobile,3393876,137346,0,0,3531222,2022-10-31
bf625e06a2ca37ac,mint,4146017486,56975473,1039762,212495,4204245216,2022-10-31
ff0081e3748ae8d6,,1014519297,36742820,0,0,1051262117,2022-10-31
feaaf94b96dc43e8,,138588864,2149177,0,0,140738041,2022-10-31
18c61f6e8ec51ca8,mint,372180540,6372634,21703,13879,378588756,2022-10-31
bdfedc0cdac8caba,t-mobile,1395481177,63323339,48987,25152,1458878655,2022-10-31
b929028d9fefd102,t-mobile,621883496,59635757,113,170,681519536,2022-10-31
f0bbe0d98d21a5d1,verizon ,270128774,31832029,642792,60801,302664396,2022-10-31
45d6133421def027,t-mobile,584792771,49523256,1080461,208046,635604534,2022-10-31
d293de270940b7cc,,875674,232306,0,0,1107980,2022-10-31
d86c922e983103ab,,147931994,1219341,0,0,149151335,2022-10-31
2ff3255a121d3bca,mint,720791156,54635404,83935,33802,775544297,2022-10-31
05e25120ad0aa496,t-mobile,949642468,77744996,6651,3468,1027397583,2022-10-31
7b6d5676f918872f,,102633174,9516047,0,0,112149221,2022-10-31
9aaeed823cbe0123,verizon ,453129226,29142913,393781,10257,482676177,2022-10-31
35eb02362a38aedf,at&t,762238571,48142073,197,1767,810382608,2022-10-31
64fc4b682bef0f16,verizon ,344844899,34027473,2036007,505183,381413562,2022-10-31
6aa8879b4097a441,extended network,369030890,5476185,978649,139147,375624871,2022-10-31
6f64712e834100d1,t-mobile,1202414646,65839349,48481,21582,1268324058,2022-10-31
7ac57aad0b001368,verizon ,696637627,73786723,6609,1512,770432471,2022-10-31
397bae705bdd033e,verizon ,1449249933,104908288,16349,10589,1554185159,2022-10-31
05fffcf8dd72a323,verizon ,1234686265,55899583,2033127,281822,1292900797,2022-10-31
98103d1fd8166cce,verizon ,396504621,55844166,1133191,200371,453682349,2022-10-31
eaeaf844a56df697,mint,395481705,19294362,0,12500,414788567,2022-10-31
66b58a9cfafd50b5,mint,627373595,52837206,6863,2290,680219954,2022-10-31
63d7e3472817f008,mint,0,0,42531,10434,52965,2022-10-31
32fb93177337f070,mint,3464957341,73645657,7719,2237,3538612954,2022-10-31
33dc49553a8e6b76,mint,384999960,32420093,911164,235925,418567142,2022-10-31
bcc6a69a1fa06eef,mint,611676774,49805468,0,350,661482592,2022-10-31
6035a69c786cad77,t-mobile,639053717,62739922,1774402,272697,703840738,2022-10-31
4e737dc6f8c924a4,t-mobile,3031162624,86249985,723583,95555,3118231747,2022-10-31
2c381f6fa9a3cdb1,mint,303500608,39357645,758981,113398,343730632,2022-10-31
607d2018b5402e6d,at&t,0,0,1787974,381882,2169856,2022-10-31
3826e30532c10382,mint,1161836119,72507694,35267,11934,1234391014,2022-10-31
d867c4d188eb4eeb,t-mobile,363169474,14609620,20633091,632980,399045165,2022-10-31
56a1474769229ab5,t-mobile,0,0,1318995,91827,1410822,2022-10-31
00b428e40a993aa1,t-mobile,3593118196,70961738,20687,6993,3664107614,2022-10-31
2bff8efbe43a62e7,t-mobile,956620405,57841913,14172,4791,1014481281,2022-10-31
8aecd6fe68b57e26,mint,800284033,52081275,554,209,852366071,2022-10-31
91ec27df513f540b,mint,830974072,57057518,7153,2224,888040967,2022-10-31
07baf072401e5473,t-mobile,806094032,62859478,6935,2140,868962585,2022-10-31
91dd8ec9a18908ed,t-mobile,605493349,5860102,30853,9233,611393537,2022-10-31
f1a42b68c0a6a6a1,mint,653873559,41896173,6935,2212,695778879,2022-10-31
0085179378d4b0c8,,611710621,55435293,6672,1876,667154462,2022-10-31
f8fb5070f462777f,mint,548126171,58310266,68988,24070,606529495,2022-10-31
2ca8e333ea1f54e0,at&t,121160728,3269589,768017,101052,125299386,2022-10-31
3c4b563e4bdc9875,mint,381042506,27622257,1326924,90828,410082515,2022-10-31
e6ac518b01a5650f,telcel,1315471150,71673810,58797,16122,1387219879,2022-10-31
06e73fb42c9e381f,mint,847793974,58652373,1018534,161585,907626466,2022-10-31
d692caa726ea41d6,t-mobile,722512433,49504736,657682,35155,772710006,2022-10-31
c0f9e88447238c98,,509106033,42902483,159715,150866,552319097,2022-10-31
33dfa2a528659fbf,at&t,457300826,20441494,43763,18725,477804808,2022-10-31
598e45eca2d96127,at&t,1120870221,54811698,1312594,65505,1177060018,2022-10-31
b41c63ab69c24833,home,371705,760885,0,0,1132590,2022-10-31
62a32d770ed199bb,t-mobile,808861683,48991013,16017,2733,857871446,2022-10-31
4990057ebc4d315c,verizon ,1239381096,70414445,13759,4026,1309813326,2022-10-31
39b33af1c0d21fc6,verizon ,568476462,50380370,166461,78047,619101340,2022-10-31
809d8ff6dec84929,verizon ,943177468,66787476,1377709,239237,1011581890,2022-10-31
e50377b6c9b9117d,t-mobile,1004879159,56126239,1390451,329498,1062725347,2022-10-31
db61e2c90215db21,verizon ,982835579,65785030,621518,91209,1049333336,2022-10-31
770e49a673dfedad,verizon ,88248218,7784239,93516035,2997313,192545805,2022-10-31
34f9be30f0a68b01,,1083052563,88180830,37919,14179,1171285491,2022-10-31
779d22c92a91dfcd,mint,951278193,40692505,20454,5868,991997020,2022-10-31
e9f250fc5317281d,mint,976974074,58183884,182288,62682,1035402928,2022-10-31
da0358dc956af356,mint,591349609,60649058,1055843,159158,653213668,2022-10-31
d805643eb9b9f6bb,t-mobile,243047414,6240751,109444,48587,249446196,2022-10-31
3282aa8e8dfa3158,mint,38196,12988,1156494,212089,1419767,2022-10-31
2ee252d1b96dc932,t-mobile,435436912,30088453,20717890,644134,486887389,2022-10-31
bf46a98ae59986c1,t-mobile,625852394,13453550,938624,181598,640426166,2022-10-31
4d5d3d4ad5a18abe,,74518758,987688,0,0,75506446,2022-10-31
2c1cf27690af7dd0,mint,38596773,1693689,20515957,654842,61461261,2022-10-31
89b17cda6b35d7a1,t-mobile,1389043,233509,286891,101259,2010702,2022-10-31
9f188ed4a0ec25d8,mint,252545354,5611407,0,0,258156761,2022-10-31
e15b0f2f7ec645a1,verizon,673664331,24966417,774057,79007,699483812,2022-10-31
812a4a76fc2371b8,t-mobile,2988863977,64739844,556652,86015,3054246488,2022-10-31
0d6331d25e4ce27a,mint,208270836,3912151,404,1494,212184885,2022-10-31
a31e73016c72cc7b,mint,0,0,652269,73797,726066,2022-10-31
ef27ce871bd9dd71,t-mobile,857148,249975,5743,86364,1199230,2022-10-31
a6e7a91c0a538bd3,,959709,261198,95677,49244,1365828,2022-10-31
f93f7d805d3855c6,mint,467733285,5523620,0,0,473256905,2022-10-31
caad25f89af338d9,mint,757046,246114,755162,258133,2016455,2022-10-31
6f9ae92532838172,verizon ,2269893548,101623384,1604373,174150,2373295455,2022-10-31
b94f6881e9ac5683,,112904453,1477003,0,0,114381456,2022-10-31
aac1c355253a0e11,t-mobile,4044214048,125663758,64881,23296,4169965983,2022-10-31
29f6ee39d03ca661,,61727095,817071,0,0,62544166,2022-10-31
e106fccc5e1616f9,mint,778923909,56939132,44853,19865,835927759,2022-10-31
a6cf12b3d0d5ebf3,,1153545222,82302199,785094,115627,1236748142,2022-10-31
8d587cca29da2021,at&t,802002326,66584080,953479,114313,869654198,2022-10-31
e03dcb9208344d18,verizon ,847493338,76703542,33656,16911,924247447,2022-10-31
63f0f02add233130,mint,584163129,58051932,11544,8575,642235180,2022-10-31
2aecdd862145ee20,verizon ,844521750,74082198,2680172,739756,922023876,2022-10-31
996d8074c189c042,at&t,913669959,62005029,1068209,134438,976877635,2022-10-31
692c091742a0af66,verizon ,700609594,30335163,1539363,357750,732841870,2022-10-31
e0de815c6079a25a,at&t,685394953,60276417,33463,11874,745716707,2022-10-31
919adfa765989255,verizon wireless,424428939,99440609,697207,76439,524643194,2022-10-31
10596bb3b567474d,,613742685,44573496,0,0,658316181,2022-10-31
78e262f7f40ef250,t-mobile,0,0,1869777,336856,2206633,2022-10-31
af1dd780b583d2d9,verizon ,1050555688,73153975,1062234,168157,1124940054,2022-10-31
cada6d18a60944ea,verizon ,694204239,64902468,6661,1741,759115109,2022-10-31
6796212cef500980,at&t,706098546,64812181,1000693,147039,772058459,2022-10-31
26d0cd824c452c5d,t-mobile,2073944672,20967141,1287116,55363,2096254292,2022-10-31
bcddb7ff5b35d6a4,at&t,2785246597,58314774,1794355,346647,2845702373,2022-10-31
9620a0d8e8c947d9,verizon ,647901028,52016259,17820,5814,699940921,2022-10-31
96b1572362e2c5f5,mint,1335494025,69060390,24159,5021,1404583595,2022-10-31
8cd8b6142220261c,verizon ,496601290,45931393,0,170,542532853,2022-10-31
3e6a1a9192593093,,897533,253169,0,0,1150702,2022-10-31
75defc125ceaeff3,verizon ,0,0,491548,1694840,2186388,2022-10-31
6bd2276f736923e1,verizon ,134862734,12440327,1241408,229722,148774191,2022-10-31
53ff327f414455ca,verizon ,814506,232452,7435,2953,1057346,2022-10-31
be626a4490e456e1,at&t,748498243,58836669,1008038,175484,808518434,2022-10-31
105145799250119c,mint,133672039,25457332,104,104,159129579,2022-10-31
3dca8a2003f4c8ab,verizon ,1004503105,38116194,682686,264194,1043566179,2022-10-31
839b006a57bf8131,verizon ,631518907,62330378,1261815,228560,695339660,2022-10-31
168e7e80611b8514,verizon ,830373093,14608424,0,0,844981517,2022-10-31
82277fd8c6f3d1da,,408419268,2698289,0,0,411117557,2022-10-31
11a26142fb4abc9c,t-mobile,705703295,40393149,727334,62101,746885879,2022-10-31
fdd1aa2e7d188b4f,mint,443101903,72680307,3111,52182,515837503,2022-10-31
92294920d53e7df5,,161425159,3193537,0,0,164618696,2022-10-31
9442be2af854673d,verizon ,1399487491,81666856,6661,1741,1481162749,2022-10-31
c2095caf1d5ae36c,mint,54610607,1244719,7604,1948,55864878,2022-10-31
27c5ded387f94541,mint,728831955,58455378,29002,16791,787333126,2022-10-31
184ecf9a3a6ad74e,,20702420,3425729,69719,28976,24226844,2022-10-31
92436009d28bd631,t-mobile,156821169,24415047,591319,65127,181892662,2022-10-31
febd81f809773d57,mint,976998682,42676389,14069,2095,1019691235,2022-10-31
9c6583d9e1d8d572,mint,82347228,2552352,0,0,84899580,2022-10-31
db7179c60ff67315,mint,619522617,8361095,1107116,355119,629345947,2022-10-31
e3044d1810fddb3e,mint,84,84,39878442,1169162,41047772,2022-10-31
6270fc9338548a5f,mint,9397,2463,0,0,11860,2022-10-31
f37d3ada8e663c3f,mint,662303152,9523867,33812,16352,671877183,2022-10-31
2b262b2db5625483,mint,546056364,54330739,13542,11472,600412117,2022-10-31
c7dcb7bece4bed21,,793075564,12176494,35080110,881647,841213815,2022-10-31
779caf59bdbf56c1,mint,866078,271869,433847,127126,1698920,2022-10-31
9a07bdabeb86fc79,mint,1239092048,44601579,36,13,1283693676,2022-10-31
5c2b86d84342a444,mint,27639,62822,97432,31501,219394,2022-10-31
46e37de2cf13bfee,t-mobile,746184104,73034354,2561636,717626,822497720,2022-10-31
d264c4b8fb0aa8ce,t-mobile,1400898679,32095746,1049175,175456,1434219056,2022-10-31
c5141a38283b9020,telcel,393652814,48140395,7574,2418,441803201,2022-10-31
f83afa5372e16cef,mint,448452095,51837168,20178,5529,500314970,2022-10-31
7a96b4f7feaa89a2,,1410986329,71004697,1766408,188399,1483945833,2022-10-31
e760ffc488c08d29,at&t,1021238522,58777522,173560,68381,1080257985,2022-10-31
17f8fbfc7c5d0757,home,897140144,26557376,47462,18855,923763837,2022-10-31
331cb9a28fe56f0c,t-mobile,0,0,1340340,113646,1453986,2022-10-31
e29d08b5024e0ecd,,1514935,272457,0,0,1787392,2022-10-31
431fc45468578ea9,at&t,2787119178,50540433,4026,2225,2837665862,2022-10-31
d79ac017eca0ffef,,659985,204557,0,0,864542,2022-10-31
479d999d64416fa5,at&t,526068518,46432310,1120866,222433,573844127,2022-10-31
cf0775468b2a700c,at&t,745992799,55399607,64473,41277,801498156,2022-10-31
051cd907831fe940,mint,920751692,38675996,772033,137642,960337363,2022-10-31
67d89896f433cfd9,t-mobile,58458773,3794160,58281,225301,62536515,2022-10-31
f2a55319619dbecf,verizon ,704695945,69704852,6802,1900,774409499,2022-10-31
b94843a0175c0968,verizon ,737915203,54221526,20715,10703,792168147,2022-10-31
18eb2f5061bc3f9b,,933655170,47906221,1004445,191811,982757647,2022-10-31
100b2c3ad151c227,mint,538789594,62450245,0,130,601239969,2022-10-31
6ea9e390a926fe17,mint,3241151127,82049465,1019430,145000,3324365022,2022-10-31
a6710e673bac2b6c,verizon ,709171058,70860271,6713,1796,780039838,2022-10-31
580f4255fb85c65c,verizon ,809016406,53902668,84,84,862919242,2022-10-31
3d7b3a0b98f9ea9e,verizon ,760175101,68962982,65579,24221,829227883,2022-10-31
63e3fe5fba963803,verizon ,55472182,6300240,702039,54460,62528921,2022-10-31
a7d083233c76c2bf,verizon ,353376116,14368064,1306251,58250,369108681,2022-10-31
8197e8806fb44d40,mint,399625922,8553850,825849,96676,409102297,2022-10-31
e32c9f4f59764408,verizon ,388418737,33934567,129,70,422353503,2022-10-31
84b9b4d80fa001a9,cricket,3064825190,97334171,6899,1808,3162168068,2022-10-31
e3a791db43282976,verizon ,450859706,23092429,1424433,321304,475697872,2022-10-31
56a5b549ac58e0cc,mint,653832499,72583285,13489,4003,726433276,2022-10-31
e4007205b2eb46cf,,180960,149935,0,0,330895,2022-10-31
2a1b01d999da1110,t-mobile,769582118,65236957,81276,21766,834922117,2022-10-31
713ac1cabddd111e,home,892862234,57459074,2668339,510008,953499655,2022-10-31
9106dd87267c5783,t-mobile,694893894,70129246,13691,4372,765041203,2022-10-31
15e2cb397d5833a8,mint,787919985,21319414,801924,100479,810141802,2022-10-31
12bc17d5d5893958,,147805590,3261344,0,0,151066934,2022-10-31
0c524f3dd472b1df,t-mobile,47134866,6976276,2188116,322723,56621981,2022-10-31
4eddd99056bbf7d7,mint,221828452,28674160,642938,47271,251192821,2022-10-31
7135df49d694338b,t-mobile,430256424,64980490,1455215,276654,496968783,2022-10-31
1c13a6a750359ae3,,90991971,1444375,0,0,92436346,2022-10-31
f0c24ed642439113,mint,951822187,48445520,193922,78215,1000539844,2022-10-31
dd4221608a619708,t-mobile,1039639439,35624954,84,84,1075264561,2022-10-31
5e1dee99b5001e09,mint,1246181096,66095598,2287962,681098,1315245754,2022-10-31
a0897ccaf88367f7,red pocket,1011129443,81068087,676777,192019,1093066326,2022-10-31
cfd0594e50311c81,mint,1808153815,87690502,142761,11009,1895998087,2022-10-31
0cc389f0eb117d49,red pocket,263996290,8869620,187172,62093,273115175,2022-10-31
f15807fb8f6ab940,mint,481756433,18111260,0,0,499867693,2022-10-31
2f6f65147fa0ece2,,185603991,2804094,0,0,188408085,2022-10-31
373e2ded60921533,t-mobile,847444,256252,271630,99537,1474863,2022-10-31
4cb66e3e06580156,mint,928530136,30365633,0,0,958895769,2022-10-31
029edf2c51f9caa2,,10895,362710,0,0,373605,2022-10-31
a4f335287f45fd98,mint,851644,242483,7785,2343,1104255,2022-10-31
d472b7db0eaa58bf,mint,94646,244131,0,0,338777,2022-10-31
bbaefa295ba4db93,,184042097,10218792,0,0,194260889,2022-10-31
f76cfc84f16f868a,mint,1349923484,75480472,28456,8985,1425441397,2022-10-31
066a71f8877ddc8f,,1009999752,39492851,778124,152760,1050423487,2022-10-31
7d3bee85b1eca91f,metro by t-mobile,417949,47426,610253,123187,1198815,2022-10-31
86cb8ba895f37170,t-mobile,617025953,52837414,6482,1524,669871373,2022-10-31
05fc30b4cf08c2c7,metro by t-mobile,293754,75421,588940,205637,1163752,2022-10-31
7e4ed40f27143f40,mint,398877866,27487218,0,0,426365084,2022-10-31
663cd853d0e1b36d,t-mobile,650444626,19913333,84,84,670358127,2022-10-31
467b72847780b481,mint,1585696,280046,35946,20294,1921982,2022-10-31
223d5bf1961cfc5f,,29163,9584,0,0,38747,2022-10-31
f1debf2fe0858f6e,t-mobile,0,0,169114606,3921752,173036358,2022-10-31
cb7aa37035e8a870,t-mobile,3160145,1049085,11753,6592,4227575,2022-10-31
b37bd5c95ef52c17,mint,20254966,479439,20589,5943,20760937,2022-10-31
3a0d526894c5ef33,t-mobile,0,0,78784,89426,168210,2022-10-31
85b94dfc6685c83c,t-mobile,609197250,36540449,35500,11818,645785017,2022-10-31
70767e6436789c4b,mint,376370005,37976491,15879,5551,414367926,2022-10-31
322f58cee42828cd,mint,1582578364,56759835,0,0,1639338199,2022-10-31
dfa1b599a9329070,mint,78415683,2817707,23866,9237,81266493,2022-10-31
fa8f0a84f614e766,t-mobile,837350951,22609263,0,0,859960214,2022-10-31
849826b7faa9cc00,,267706042,28668587,25461,14028,296414118,2022-10-31
1462923fdf0f522a,metro by t-mobile,783020,213855,605332,198626,1800833,2022-10-31
2e50711afe831958,t-mobile,443958712,41983465,0,0,485942177,2022-10-31
f88f8b6596f9ddf7,verizon,890940466,63218777,1522939,237523,955919705,2022-10-31
837e51c94baf9956,,57490533,1388882,0,0,58879415,2022-10-31
ec59464b6f472427,mint,552424193,49645300,127495,47010,602243998,2022-10-31
47f9f03a11dfde71,verizon ,29205983,3553875,205,195,32760258,2022-10-31
ce0930eefa60067f,at&t,760646567,77124225,16473,7042,837794307,2022-10-31
3416e05e3445389c,at&t,1131468357,90795666,67783,19337,1222351143,2022-10-31
99d71903fde4c50c,at&t,622450097,57478557,1386954,160446,681476054,2022-10-31
d2a48c1959c6b119,,205741,684479,0,0,890220,2022-10-31
67c3b1041a15e3e8,at&t,1935818587,104841980,2248875,382979,2043292421,2022-10-31
ca76da41fb26ea7f,verizon ,661787558,74569018,1291620,57795,737705991,2022-10-31
517f460badec2167,verizon ,0,0,836698,121257,957955,2022-10-31
b7d5152479087658,t-mobile,4432989836,136835011,6853,1983,4569833683,2022-10-31
1cad028e5d1d4c07,at&t,1501226746,44505386,6725,1753,1545740610,2022-10-31
2dcfe0419c33a5c5,tello,1162381033,68952388,493933,122584,1231949938,2022-10-31
b30fc63cdf60f953,verizon ,621718862,12370696,38246,10336,634138140,2022-10-31
14c6debd937c8e4c,,490123081,29313460,252467,93496,519782504,2022-10-31
934cfe5e487cdd3a,verizon ,473311223,17058575,1845175,239806,492454779,2022-10-31
dc7476f22e4ae089,verizon ,737790710,48823631,1820623,223123,788658087,2022-10-31
e8941f431227fb8a,at&t,469222313,69771145,6897,1817,539002172,2022-10-31
62f868156b862213,verizon ,638402380,42668319,746689,78874,681896262,2022-10-31
edf3c80383463944,mint,718479882,80075294,33496,8984,798597656,2022-10-31
5dab0c93874f1ad6,verizon ,1431729,235247,456498,30372,2153846,2022-10-31
44b491b644826755,at&t,177670911,16918519,623703,27696,195240829,2022-10-31
6b0ad2e9163e1c7e,mint,2226688906,63703815,113623,40169,2290546513,2022-10-31
39306489ed70b90b,at&t,1005419802,92437384,24318,12009,1097893513,2022-10-31
fc84e3b936543cdb,verizon ,808045398,54019527,1865880,244226,864175031,2022-10-31
f24dafcf0a62062a,verizon ,5043079871,145843272,1306567,57201,5190286911,2022-10-31
2b55f572511abbf4,mint,73207663,10221558,84,84,83429389,2022-10-31
14ef3319c242c4fb,mint,897840326,63626670,84,84,961467164,2022-10-31
bd79f0eef4c80769,at&t,451984539,34056770,1328434,126907,487496650,2022-10-31
53be1ffcc7754820,verizon ,155700488,2594964,667617,38929,159001998,2022-10-31
16ad9076dcaa1236,verizon ,186373,72695,1293719,68104,1620891,2022-10-31
2cc51cc20006289e,at&t,681609401,66978287,785349,105844,749478881,2022-10-31
a8165c4c2512df3b,t-mobile,681752548,75720326,134166,55057,757662097,2022-10-31
5c78728fc958a96a,mint,638046868,66609409,0,0,704656277,2022-10-31
8b644e6c85ba5b3a,,806525451,80886941,1552929,456895,889422216,2022-10-31
d505b0df03690d61,verizon ,968311845,53019558,1209388,225936,1022766727,2022-10-31
a4abffd08ccd87ae,verizon ,527662613,43010765,279652,93535,571046565,2022-10-31
ead78b4b30ded453,,69309870,1685425,0,0,70995295,2022-10-31
77c301e674ba504a,mint,1476697291,48290473,0,0,1524987764,2022-10-31
21f5d44ec532eefa,mint,1510129868,70732082,654458,45923,1581562331,2022-10-31
887c50e140018d1d,mint,1026706,213763,234649,89378,1564496,2022-10-31
2e1412aa92227533,t-mobile,69757,122961,19843331,471400,20507449,2022-10-31
46041a45f309fe34,mint,980488232,56810550,38255,24055,1037361092,2022-10-31
3242d9192f1947ed,mint,643459075,8748170,10606,62885,652280736,2022-10-31
75f7c8f136f44258,at&t,408260813,26155384,0,0,434416197,2022-10-31
1f0e4ec7c817aa52,mint,0,0,1325370,78543,1403913,2022-10-31
519d30c645287f96,,563551291,34987562,703318,85321,599327492,2022-10-31
62ccc43244a13016,,694416921,26890912,8397785,259691,729965309,2022-10-31
4ba71ce616052b16,mint,1416342961,28766777,562330,31204,1445703272,2022-10-31
60b62d017d6c2977,mint,681757992,78339970,7151,2368,760107481,2022-10-31
aa50c17c78bb49be,mint,1109513,216760,29710,10564,1366547,2022-10-31
ca56dd09da0890a3,mint,686257385,64969283,1306734,188521,752721923,2022-10-31
63d8cd4aee397521,mint,804494855,13622349,0,0,818117204,2022-10-31
0d9a7bf968c85d73,,221552217,4654758,0,0,226206975,2022-10-31
ca23917a9688926b,,201760205,3749440,0,0,205509645,2022-10-31
57bee96a6e93d389,mint,476379557,57786535,0,65,534166157,2022-10-31
ff6dc7f3ece3dbc7,mint,30474142,1547847,104,104,32022197,2022-10-31
39c4146e1bd963a3,cricket,193061047,5473141,755668,149074,199438930,2022-10-31
1e1fa9158eede08b,verizon ,742775279,17860722,1281886,346459,762264346,2022-10-31
2292bbf24424f85f,t-mobile,1053245933,72202329,53925,21754,1125523941,2022-10-31
0c3f36f42c204c7d,verizon ,445765612,55942899,20809,5900,501735220,2022-10-31
24666a6415bc9891,at&t,465024426,46987179,930785,153758,513096148,2022-10-31
f0208957562eedf1,verizon ,1378461540,59567300,84,84,1438029008,2022-10-31
6a9250d1b9b03b4a,mint,1438665718,58194636,1312183,1675430,1499847967,2022-10-31
de118f5dd9a217df,t-mobile,996935211,81070363,220833,76557,1078302964,2022-10-31
f9af1d0a97d3e536,verizon ,262177374,10606234,119792,30152,272933552,2022-10-31
06d23c8b8d8eb2fb,verizon ,0,0,22790,4582,27372,2022-10-31
870ac0cebbdd4b37,verizon ,36609,10423,1153759,279626,1480417,2022-10-31
82303e85ac2ef051,verizon ,800719705,71348559,730451,66026,872864741,2022-10-31
6e1b9dbf501a90ee,,864786925,79173348,804018,102531,944866822,2022-10-31
fee005ebbe519017,verizon ,77255170,2009963,168875,16551,79450559,2022-10-31
81dd1602e1895469,at&t,640044468,30519704,283,3074,670567529,2022-10-31
74b50562f80ac3e9,mint,1262425563,57223514,6935,2068,1319658080,2022-10-31
a506ab4cb91271ed,,285850950,39825768,757010,81518,326515246,2022-10-31
f697973fc1222e58,verizon ,555452635,45352081,252,252,600805220,2022-10-31
db95309e28d0d27d,,164972356,3509551,0,0,168481907,2022-10-31
be24db6993c51e2f,,151810469,2617745,0,0,154428214,2022-10-31
646254d573981f86,mint,453892099,32602325,54735,20154,486569313,2022-10-31
9d6e900d30a81f25,mint,665393123,27709910,295991,32435,693431459,2022-10-31
70d2594821be56d0,mint,208750282,7353710,0,0,216103992,2022-10-31
5f303423cab8b4e9,mint,1360413677,126988184,966618,180248,1488548727,2022-10-31
92eae2bb0d19e4b6,t-mobile,632248876,37351477,0,0,669600353,2022-10-31
52e75330538bdf9d,mint,162296746,27477788,2357723,617517,192749774,2022-10-31
15b821162ad4c762,,3005512,406109,0,0,3411621,2022-10-31
ac1e32499387d7b8,metro by t-mobile,620928146,76303877,1906590,312295,699450908,2022-10-31
0d6dba219fedc20e,mint,606937815,51463273,28522,9766,658439376,2022-10-31
1c25160c1ff75c8b,,1425511,239098,68343,22803,1755755,2022-10-31
2e8ccf83c5b72a52,metro by t-mobile,3500252539,97579320,804880,104029,3598740768,2022-10-31
cb18a253309d37e1,t-mobile,427850850,39873791,647278,58924,468430843,2022-10-31
3516accb84d548c0,mint,650590705,13667731,21599,3462,664283497,2022-10-31
7130780f19fd1899,mint,436427903,38247353,35315,11488,474722059,2022-10-31
58d78bc4e57303d6,,731646111,48745724,139485,56639,780587959,2022-10-31
47c7f689cf1fd36e,,147248345,3729417,0,0,150977762,2022-10-31
15849f5aec746a9d,,35295682,1277636,0,0,36573318,2022-10-31
3d60996fc04e6414,mint,1176378686,46058296,0,0,1222436982,2022-10-31
1b7879fbcb4af035,t-mobile,766382108,50804889,1303403,90747,818581147,2022-10-31
ea30814e80860963,us  mobile,122489467,2129928,73657,37384,124730436,2022-10-31
927d8590839b8ab4,mint,2431981918,18209095,1359847,81490,2451632350,2022-10-31
1727b4f92ed519a1,metro by t-mobile,0,0,35573355,666788,36240143,2022-10-31
1de66756e965193e,mint,823131019,44899830,1047441,167739,869246029,2022-10-31
a0663be0f8fe48ce,mint,793821054,66699149,0,0,860520203,2022-10-31
66a78c3f532d5e93,at&t,445316672,30797917,29918,10302,476154809,2022-10-31
42516985e0033271,at&t,853292154,49359668,844448,90817,903587087,2022-10-31
e1c07140f3df1a2f,mint,1030240504,54229563,514831,19429,1085004327,2022-10-31
3a6f8af7874d6256,verizon ,701363535,66765470,0,0,768129005,2022-10-31
dec708cf4441bc73,mint,44586455,5205288,1084686,292589,51169018,2022-10-31
f1bb6c34cddb328b,verizon ,521295616,56307769,109117,30612,577743114,2022-10-31
b50bc827ef2fa419,at&t,106292487,5533891,1294281,76965,113197624,2022-10-31
1176b24c5d543294,at&t,684034487,65755114,6138,1145,749796884,2022-10-31
f2499ff419064620,verizon ,478066717,54658864,74546,20809,532820936,2022-10-31
e8bdb4e592d26484,at&t,469008748,59457752,766747,77262,529310509,2022-10-31
d6a95765e9a27986,verizon ,122211673,17201732,2206760,294732,141914897,2022-10-31
6164e17aa5fe7786,mint,1531881018,20573409,20281,4266,1552478974,2022-10-31
6f2abcbc54ba80be,mint,93226457,12176747,876398,82549,106362151,2022-10-31
d277fc1a6f86c5bc,,161338523,3727797,0,0,165066320,2022-10-31
cc46a3f453c26811,google fi,848740008,67350142,1169393,100662,917360205,2022-10-31
9f031cd881e206d3,t-mobile,107822022,11566403,0,0,119388425,2022-10-31
ca1801dc31e2ca8b,,359334244,26058824,6057,1312,385400437,2022-10-31
a990362073cf87ee,mint,18868508,1958047,1088,8445,20836088,2022-10-31
6b2b982140e27872,mint,1016168854,60160574,58246,15431,1076403105,2022-10-31
04e976418635edbd,mint,470995984,42383478,36202,11248,513426912,2022-10-31
22eb77c4f4b90cda,mint,1148012667,66285994,137943,44595,1214481199,2022-10-31
b1b6ceb978cd7da0,at&t,543218535,7366150,84,84,550584853,2022-10-31
73cea630673f7746,at&t,1906649793,82435918,0,0,1989085711,2022-10-31
4591728a501e21fb,t-mobile,493786973,45126308,1344215,104373,540361869,2022-10-31
8d3973e721ab76d6,at&t,773153079,37715086,13210,3898,810885273,2022-10-31
eb0757db1d668949,t-mobile,633083182,45359812,618682,33234,679094910,2022-10-31
7318769442c76310,t-mobile,657394748,61898030,863167,107988,720263933,2022-10-31
c8bf53fed1d57909,mint,590447851,52630922,178137,69073,643325983,2022-10-31
fd67213e72c1d58c,t-mobile,631741103,15286683,104,104,647027994,2022-10-31
186eb3c59b43874e,mint,3353930769,83479261,22498,6212,3437438740,2022-10-31
445b22d2016f0e21,at&t,187080398,15128172,1950258,278334,204437162,2022-10-31
6f735ddfc9432165,mint,768358401,53104921,43277,21563,821528162,2022-10-31
2f7ac3d8047415cb,at&t,1171091116,55370979,98328,27399,1226587822,2022-10-31
3aefefbee399d250,t-mobile,1569027113,40286107,185392,226364,1609724976,2022-10-31
73f97109bb32b069,t-mobile,872702775,46615799,577795,53285,919949654,2022-10-31
9c032db876dca409,ting,1467160302,45577403,1998733,306021,1515042459,2022-10-31
d85c8ac620219ec1,mint,1464788291,72686159,1120119,196559,1538791128,2022-10-31
b68a3ae663e3637b,at&t,876513813,62025319,642507,35296,939216935,2022-10-31
26747c6a16123ee3,cc network,759021988,40983499,1300336,92132,801397955,2022-10-31
4e949a3b79a8294f,verizon ,1128100605,79228881,48028,14397,1207391911,2022-10-31
eef233c8c7a54579,verizon ,488796358,86021572,22804,10039,574850773,2022-10-31
1c16a16fa1c5cf6c,mint,2649004868,82140410,6737,2019,2731154034,2022-10-31
428325f47c4e43d1,,571608612,51912724,192599,67293,623781228,2022-10-31
56932f1f306dc1cf,mint,354661024,6195473,1532371,241526,362630394,2022-10-31
c503e5e1978a1753,verizon ,1424069519,71532611,1599745,275684,1497477559,2022-10-31
13373f3b3c31ffdc,at&t,1139984773,86899670,13753,4074,1226902270,2022-10-31
a47208263aae9553,,2006650,808451,0,0,2815101,2022-10-31
fb0bae60a5f7831a,verizon ,466912900,68414070,1066273,172498,536565741,2022-10-31
031cef635b50be39,,170146706,3142068,0,0,173288774,2022-10-31
4d9556acaccdf9e7,t-mobile,1255831720,52501843,1897679,97225,1310328467,2022-10-31
eff2ed16822a4c95,,226396889,5532480,0,0,231929369,2022-10-31
4d943d3e9833fa92,mint,738303956,19308812,654688,43971,758311427,2022-10-31
0432829ba07ae679,at&t,986093641,55492215,1948862,280445,1043815163,2022-10-31
c635d43203f35a29,t-mobile,4505632797,118496209,1336818,267585,4625733409,2022-10-31
91edae96f00aebb9,,59866550,704604,0,0,60571154,2022-10-31
8a2a21f28f911e34,mint,5603682790,109731782,6672,1948,5713423192,2022-10-31
9704a181825090b5,,102167742,2113034,0,0,104280776,2022-10-31
be663d43344cd515,mint,222070024,3282893,47366,15107,225415390,2022-10-31
65e2711b7ac5ce77,mint,3230389687,103630309,19438,11444,3334050878,2022-10-31
7b1123b9ff399000,,1543651,301882,686708,115557,2647798,2022-10-31
833ac971c80b8955,at&t,1460467,249943,53058072,1153984,55922466,2022-10-31
2a4e82107ab19a7b,,153870346,2029581,0,0,155899927,2022-10-31
ffab95aedd6b7f1d,verizon ,402399792,38928606,1689951,287222,443305571,2022-10-31
54fafb6fd040e1de,verizon ,923397166,67755956,714494,63626,991931242,2022-10-31
012268e360f9c23b,verizon ,3727087698,99249308,22129,8921,3826368056,2022-10-31
2fa90beaf33be0bc,,407011530,8251009,0,0,415262539,2022-10-31
b0180caff170671c,at&t,3742794172,100999717,104446,41830,3843940165,2022-10-31
5e934bd41f8ab5f6,cc network,995205751,96905824,97886,34570,1092244031,2022-10-31
8cd18c743d15e03f,verizon ,1313713,474707,639960,23709,2452089,2022-10-31
693012729de0694b,at&t,4017994934,82812917,752297,59958,4101620106,2022-10-31
2397c6fddbff05d1,mint,2919728694,66067168,84,84,2985796030,2022-10-31
4183b319def3c4d1,,1148946357,13481636,0,0,1162427993,2022-10-31
e9224952fa17b114,t-mobile,3414308758,84423942,660695,36530,3499429925,2022-10-31
1ec30dee40763a01,t-mobile,201575658,14001055,6744,2199,215585656,2022-10-31
e18783c58351d604,t-mobile,610388403,64204776,981356,166280,675740815,2022-10-31
079be3ca3d6cd54e,mint,771131892,51237251,708660,76709,823154512,2022-10-31
f7d651a0a3256606,mint,535256142,34503951,26194,12415,569798702,2022-10-31
8c3efa69a25d74a2,mint,1706482594,47195365,1360393,119978,1755158330,2022-10-31
a0eadbce02ee8be3,t-mobile,582795575,31701666,901676,114437,615513354,2022-10-31
3a3218b642d2bd4a,at&t,73687680,11545678,88,68,85233514,2022-10-31
550ae046e1151e64,t-mobile,564971362,30008771,725969,73438,595779540,2022-10-31
3b5fcf8c57835c4d,,674186962,57770359,1624025,338913,733920259,2022-10-31
44c72ff33b4eede8,t-mobile,980383153,64295571,494301,180432,1045353457,2022-10-31
bd3a84adb7ab2e5b,mint,559083187,45928159,63676,26340,605101362,2022-10-31
c0e6d361ff503336,mint,5728994165,82011785,6935,2284,5811015169,2022-10-31
f52c04fd516a4849,t-mobile,512654933,36372546,43329,129893,549200701,2022-10-31
ac9949a16a519dea,,614133669,19804374,104,104,633938251,2022-10-31
ee17eefa8d6aa78b,pure talk,587617717,59554025,36913,23398,647232053,2022-10-31
643d24fd690e949e,mint,577549603,54260606,660555,58203,632528967,2022-10-31
f108250731a2254d,mint,1021042008,62891316,7128,2319,1083942771,2022-10-31
02df917a59f34527,,509319056,57554503,0,0,566873559,2022-10-31
bcef3c6ec96f1101,mint,1339747711,65604163,1221865,269558,1406843297,2022-10-31
98fa89e02b6b73e4,t-mobile,970115501,46870120,0,446,1016986067,2022-10-31
7ea26bc33cc05dd4,mint,766247763,29400003,0,0,795647766,2022-10-31
dc61f8e2780a29fc,at&t,162283462,2464863,857743,109390,165715458,2022-10-31
4e5dada537559478,mint,1514015385,73187786,21076,8666,1587232913,2022-10-31
d19221752d7bed0d,mint,3595785251,95213544,1254,510,3691000559,2022-10-31
3cabba7be2c17e59,t-mobile,926762379,18323472,746053,72130,945904034,2022-10-31
cf9b2236d24dc7aa,verizon ,412355614,41149017,99408,4940,453608979,2022-10-31
1aa3f9e2ebc2bb80,t-mobile,1199419661,73850517,714166,42166,1274026510,2022-10-31
fbd556bba97f51f5,verizon ,1411033159,67541528,7200,8952,1478590839,2022-10-31
5733b7d63852edde,mint,604779219,69438198,13354,4699,674235470,2022-10-31
ae8d663a466ee9d7,,102953,435978,0,0,538931,2022-10-31
e50ca0a9461dbf9c,verizon ,360584921,11518942,1317355,91562,373512780,2022-10-31
9feca65d4429a6b4,t-mobile,3641025302,93958586,6935,2140,3734992963,2022-10-31
b77550a3e8026972,at&t,911461642,47037888,1830120,464841,960794491,2022-10-31
e4be22260e6a23a6,verizon ,316741582,21831007,1325746,93904,339992239,2022-10-31
0d749014507fefe8,mint,557784920,15634632,2716844,734762,576871158,2022-10-31
fcaab505627681f6,verizon ,2550578742,104190652,61287,16606,2654847287,2022-10-31
3e7d4ec4744c6b59,verizon ,495960669,56364394,1798381,225784,554349228,2022-10-31
67468966e6dece1b,verizon ,650121185,61341879,162038,53581,711678683,2022-10-31
e1c676cbe14edcfa,,293855144,19902424,0,0,313757568,2022-10-31
d04af3613dd749f4,verizon ,1638753927,75932577,22017,6875,1714715396,2022-10-31
f3a3a346ae9b0bf4,,34274494,1077264,0,0,35351758,2022-10-31
0050dd12144553b2,verizon ,2283876326,57248438,1837068,239504,2343201336,2022-10-31
65185c8447c45be7,t-mobile,693688605,73940890,951585,130206,768711286,2022-10-31
50101e0892b89498,,1017405,425716,0,0,1443121,2022-10-31
e9e49cfca3612527,at&t,665051582,24901071,1943903,271867,692168423,2022-10-31
0dc633d947fbb01f,telcel,155742661,12616771,167265,46007,168572704,2022-10-31
c5ac32c849573cee,mint,657487709,56246146,659719,46088,714439662,2022-10-31
d977aff3185390b0,mint,1568562286,54834926,766119,69777,1624233108,2022-10-31
4dc529a1b5d68d4f,mint,566578959,26433282,0,104,593012345,2022-10-31
ba2ab59ad573c1bf,mint,1660452913,51963925,690257,51494,1713158589,2022-10-31
aca211e4ab709095,mint,402657120,45953420,208,208,448610956,2022-10-31
0c453561f6781521,,360066389,23813600,651297,35973,384567259,2022-10-31
2d696aaa9259617d,mint,712240551,62610982,7007,2419,774860959,2022-10-31
53fa067c5399940c,t-mobile,1065811196,54943939,1471285,143060,1122369480,2022-10-31
75d0bce61238d6e1,mint,537631076,48569978,0,346,586201400,2022-10-31
ff77ae10f1a29470,mint,382201181,38130430,1468838,232546,422032995,2022-10-31
9d183df45ef41a94,mint,380226253,24992684,1808680,282785,407310402,2022-10-31
4a4e73af62b15595,t-mobile,955780416,26638016,1151621,193744,983763797,2022-10-31
fe57d71cb588290d,mint,807730806,57708258,10168,3063,865452295,2022-10-31
108f61828311bacc,t-mobile,610317388,49145496,52803,14398,659530085,2022-10-31
66a3e385592f18cb,mint,804758056,56120494,969001,148220,861995771,2022-10-31
1f1225490283f040,mint,1305687161,64506224,56942,19111,1370269438,2022-10-31
348d1b5dbf704933,mint,644882021,62569324,1513972,161889,709127206,2022-10-31
0c03a809da085d40,verizon ,145208285,17861647,275233,89839,163435004,2022-10-31
b7c06aba61255ff9,,572526511,45354598,0,0,617881109,2022-10-31
c6e7334bd7aff847,mint,418482866,32330536,43784,202902,451060088,2022-10-31
e897c9b7c8f352fc,at&t,700077304,56064714,11718,1697,756155433,2022-10-31
9db95318738dff05,at&t,527725591,57925878,2516576,515352,588683397,2022-10-31
b2e0d6812db025b4,verizon ,635941841,42357476,21638205,378384,700315906,2022-10-31
6217594af3f75ecb,verizon ,856238035,74040789,724954,106710,931110488,2022-10-31
1d727574840d292e,t-mobile,0,0,1518935,98449,1617384,2022-10-31
9ffbabc0075774b5,verizon ,657900070,74490828,1320651,96418,733807967,2022-10-31
3873f88a194fa662,at&t,644521,34989,1500478,154973,2334961,2022-10-31
2ef08656bd1043a1,at&t,960512312,74677525,1416618,231506,1036837961,2022-10-31
c3b0999f78fcbf43,gsma,891192335,86197457,1057,322,977391171,2022-10-31
59f224b3d58284c3,ting,720184097,71383395,118392,43257,791729141,2022-10-31
84305707045a6265,mint,784546140,62817997,412697,58456,847835290,2022-10-31
18e1399810291bf7,t-mobile,421164401,10110563,2064900,286670,433626534,2022-10-31
b7e09ca2b99d0268,t-mobile,633836041,57401142,1307958,75209,692620350,2022-10-31
6d67f5fd4a3f29a0,google fi,620121509,49129273,0,65,669250847,2022-10-31
c811a0b3554573af,mint,808234697,66663713,0,170,874898580,2022-10-31
6bfcbf54abeb1f50,t-mobile,846299195,71119511,742971,66495,918228172,2022-10-31
00ec6dda0d58541b,,402939,108149,412714,127132,1050934,2022-10-31
41d9963f34179c71,t-mobile,0,0,28909308,1855711,30765019,2022-10-31
192309a456a31ec8,t-mobile,1176162845,20138842,0,0,1196301687,2022-10-31
52e4502bef26d635,t-mobile,922120683,72208886,0,0,994329569,2022-10-31
18ed01a4603bb94a,t-mobile,0,0,0,0,0,2022-10-31
f857f3288584e4dd,verizon ,0,0,1117067,222203,1339270,2022-10-31
fc53a9968d289d0d,verizon ,202396177,3367985,39110489,2018640,246893291,2022-10-31
2d9dbbe140121127,,474894489,17328272,0,0,492222761,2022-10-31
3aac6f8da78457f7,,955786200,116069880,0,770,1071856850,2022-10-31
dbd26f76b080a1ec,,879734,264927,0,0,1144661,2022-10-31
b1f1f13c776d075f,t-mobile,0,0,0,0,0,2022-10-31
78d85f367ca1448c,,467947,121245,0,0,589192,2022-10-31
dcedf2da6ba3983e,at&t,0,0,0,0,0,2022-10-31
537274f5decb3a65,t-mobile,311098743,21432681,651386,49612,333232422,2022-10-31
42cb787b546729d7,,205625558,3597232,80075,192372,209495237,2022-10-31
ba7175ca81dbdbfa,t-mobile,204459769,3266601,42246,16945,207785561,2022-10-31
0cea90ff2ef63df2,cricket,135796,49081,723159,220234,1128270,2022-10-31
42bb8f1ee5709d43,,852568,241779,288438,104380,1487165,2022-10-31
a24430ec472a5cc0,,11874342043,180828922,0,0,12055170965,2022-10-31
a766de744eeb27d1,t-mobile,5984696193,151287518,771583,83923,6136839217,2022-10-31
cb877043835f526b,,206295872,3116375,31787633,474800,241674680,2022-10-31
f262310ef00b774d,t-mobile,0,0,0,0,0,2022-10-31
f42fae328a1413d3,gci,3461610726,116235010,221085,82725,3578149546,2022-10-31
b8bc191fa6308ad4,t-mobile,81134059,2958411,12814,125804,84231088,2022-10-31
a591c716db3b397c,t-mobile,0,0,0,0,0,2022-10-31
533cdc21f670fc5f,t-mobile,0,0,0,0,0,2022-10-31
a2bc50818147915d,t-mobile,1247380635,59701535,138280,47179,1307267629,2022-10-31
0f894d9caead800f,t-mobile,0,0,0,0,0,2022-10-31
25df0e64a3fecff6,t-mobile,0,0,0,0,0,2022-10-31
314cd9d22b61cf3e,,299425542,50524167,986772,221368,351157849,2022-10-31
0da93729c76fadbf,mint,1466345624,38101657,13819,9244,1504470344,2022-10-31
0ec59b120a79cc9d,t-mobile,622928630,35383581,879896,148881,659340988,2022-10-31
3807433fe6354385,t-mobile,933582725,61831305,0,510,995414540,2022-10-31
0f1157f806a154fd,t-mobile,0,0,0,0,0,2022-10-31
e01b0c11b42ee63f,,26770000,4306597,0,0,31076597,2022-10-31
9c3bfae0b25612de,,62457,16201,0,0,78658,2022-10-31
818858979ca3ec15,t-mobile,75677902,8732995,0,0,84410897,2022-10-31
044e5b6346cc390f,t-mobile,678654413,11219819,123202467,1571242,814647941,2022-10-31
fbf4457e5b9cc1d2,t-mobile,0,0,0,0,0,2022-10-31
ecc46727a8c39a9b,,481563345,61103094,746589,73969,543486997,2022-10-31
b75950944fc3684b,verizon ,281541198,4375570,176971795,3960135,466848698,2022-10-31
8357baae9e65863a,t-mobile,557790496,73999494,21895,7484,631819369,2022-10-31
e6fe4b398b759f8a,,629697,201368,0,0,831065,2022-10-31
51b0c63cdf2097ce,t-mobile,224319,135471,278119,84541,722450,2022-10-31
6ac738cb3358cfbb,,102931674,6087542,0,0,109019216,2022-10-31
83b099c54a30539c,t-mobile,0,0,98621067,1060094,99681161,2022-10-31
788025264652e08c,t-mobile,0,0,0,0,0,2022-10-31
bf75d6eb0e6e6cbf,verizon ,753498,27004,1092844,537560,2410906,2022-10-31
9c1c24a8b7d6d574,,949718024,23342189,0,0,973060213,2022-10-31
1016a42b15192ed3,at&t,780913,262764,352660,111990,1508327,2022-10-31
b739a58b608caa61,at&t,0,0,0,0,0,2022-10-31
2bcac2a03b846294,t-mobile,42781,11474,1038589,350793,1443637,2022-10-31
0b323fbab6a25c18,,43646991,820728,2540,18971,44489230,2022-10-31
54b8177faf65d026,,280956,565100,0,0,846056,2022-10-31
fdcf50e1fdc7725d,cc network,0,0,0,0,0,2022-10-31
d2c147f4b1340c16,t-mobile,741514,197327,0,0,938841,2022-10-31
6b74fb865d24a350,t-mobile,0,0,0,0,0,2022-10-31
f7cced6d5b00ddb6,,64522272,7148167,0,0,71670439,2022-10-31
9580937e6d464981,,725357,193132,132582,33226,1084297,2022-10-31
233ce28fa27798d4,,424032,128773,0,0,552805,2022-10-31
598a5f6b833cd6a9,mint,736855106,64768974,1636165,190152,803450397,2022-10-31
3d9338a487ea0602,mint,1323022372,92852530,1712677,265021,1417852600,2022-10-31
6e9eef43c0407506,,301399404,22571706,0,0,323971110,2022-10-31
22d9626de5ee5759,t-mobile,730814322,71410342,1145236,209389,803579289,2022-10-31
614f793ef05faad3,t-mobile,791922747,56191325,929561,146529,849190162,2022-10-31
41da2ee4cb9b1c85,at&t,5540329,994376,0,0,6534705,2022-10-31
b06182ace9e67bbb,t-mobile,925849,244453,857470,276948,2304720,2022-10-31
5f18efd4ed3b29b6,,741520621,2314475,0,0,743835096,2022-10-31
877d0dc9fbf2aa14,t-mobile,0,0,0,0,0,2022-10-31
e2e6fbd0124ae6be,mint,659851962,46903568,765913,87218,707608661,2022-10-31
45942ff52404a1b0,mint,0,0,0,0,0,2022-10-31
36d57100a3549805,,782792100,21008775,0,0,803800875,2022-10-31
187948a35ce26218,t-mobile,5082430989,128887518,1896133,295297,5213509937,2022-10-31
a857828e58d835b7,,563289441,3991460,0,0,567280901,2022-10-31
7a747ce28d74a1e0,t-mobile,1467887,244897,276899,96307,2085990,2022-10-31
ed221f19f54dca9f,t-mobile,413222535,42619562,6140,70463,455918700,2022-10-31
fb1915be8f8a3a42,,280883384,13876259,0,0,294759643,2022-10-31
2a840b783f6d8f51,verizon ,0,0,158072480,2498304,160570784,2022-10-31
1370eefd6e0305b0,gsma,814633,262628,28940,6227,1112428,2022-10-31
13ba2e6087af16f2,t-mobile,28354,90915,0,0,119269,2022-10-31
522ba64067afd78f,,10527776,2229334,0,0,12757110,2022-10-31
b1147eb0d9ab43a0,t-mobile,0,0,0,0,0,2022-10-31
a2d4390f367d3035,t-mobile,0,0,2002149,330076,2332225,2022-10-31
3a6122a53230ff53,,363515324,6778596,0,0,370293920,2022-10-31
882cd5ccf807edd8,at&t,691987,230033,232595,78451,1233066,2022-10-31
1c234f0d0ddf4fe1,t-mobile,477820908,24977639,6493,1876,502806916,2022-10-31
22de167d807883e7,at&t,43662423,871416,45246594,1455922,91236355,2022-10-31
3ef12f4437fde3ea,metro by t-mobile,817100,237597,244769,80034,1379500,2022-10-31
0dca669e801445f9,t-mobile,794734,239014,550,8371,1042669,2022-10-31
cbb5ad03d46e0411,,421538,530458,168,168,952332,2022-10-31
aaf0858ad23198f7,verizon ,977096862,79290279,1012459,153633,1057553233,2022-10-31
88fcb3148cbb2128,ultra,0,0,0,0,0,2022-10-31
149e4119262c99bb,verizon ,6886110195,189585201,855098,115777,7076666271,2022-10-31
6c9a56007fe1ad33,verizon ,1817880009,61366726,2046526,308671,1881601932,2022-10-31
4613cff62b9b05a2,verizon ,9890516945,210907571,1084796,190857,10102700169,2022-10-31
31d887d8d28f0223,t-mobile,853299530,65917280,14216,4847,919235873,2022-10-31
51292aa404675cc7,t-mobile,373174004,5607443,0,0,378781447,2022-10-31
0c333c0e8183f332,mint,709334995,60810168,1224280,271268,771640711,2022-10-31
597f9412f4abbaf3,mint,13535963679,194316650,644440,37692,13730962461,2022-10-31
ff7c504c91bac8c9,at&t,392278053,44695046,665343,53372,437691814,2022-10-31
9bca2fc71d5482e0,verizon ,784872374,79040332,862906,97166,864872778,2022-10-31
241ecf2b58254361,verizon ,687853215,59702191,25254,5484,747586144,2022-10-31
995184913834d979,verizon ,867485317,91586719,235914,21373,959329323,2022-10-31
a30981e3cb4541e9,mint,753138178,73713206,684770,39677,827575831,2022-10-31
a3da4d81947c2f0b,verizon ,464803179,55144884,717552,46738,520712353,2022-10-31
df66b6703835f50e,at&t,619044715,67583266,26646,11960,686666587,2022-10-31
6c0fc871453099e8,mint,724819197,70960060,1823513,220073,797822843,2022-10-31
13e954d1af46a452,verizon ,503845996,64954756,131387,39310,568971449,2022-10-31
ffbabf40e3d736e8,,155930604,3778242,0,0,159708846,2022-10-31
3d799182b84f9d91,mint,416562549,40243790,20685467,218193,477709999,2022-10-31
d258605ca38a7bad,verizon ,818762417,15566846,1967132,294507,836590902,2022-10-31
dbff54f4e48924f5,t-mobile,757142036,48295283,2521595,352376,808311290,2022-10-31
ef029995650251e6,verizon ,823093278,72107852,0,42,895201172,2022-10-31
fadd7be9a3c72848,verizon ,667545639,56303155,668504,44870,724562168,2022-10-31
b5bf0fb3f76277eb,,1847805756,29539570,77274,26930,1877449530,2022-10-31
70388cf687ad88f2,,385788033,34389465,0,130,420177628,2022-10-31
176deb7867d32849,mint,925286823,66864308,37053,12598,992200782,2022-10-31
e4269ff9367fdecc,mint,1015923300,76404277,7044,2356,1092336977,2022-10-31
289838942e82e912,t-mobile,1022774162,70624934,13460,3800,1093416356,2022-10-31
a1f3e5a65c3848c6,,145936730,10733260,0,0,156669990,2022-10-31
2b39eeb82085d9fe,t-mobile,573124951,48131693,32094,14204,621302942,2022-10-31
8db235a656359f00,mint,1484721224,44584634,109960,38210,1529454028,2022-10-31
795f6b2fbd6164c5,mint,423925961,43386662,32830,12275,467357728,2022-10-31
0f9bd5235eb4cb3d,t-mobile,887114733,48118719,984191,171008,936388651,2022-10-31
fc799ae4a5104e94,,149291002,2749753,0,0,152040755,2022-10-31
e015160a975db1eb,at&t,331942684,34595504,18011,9409,366565608,2022-10-31
e06b798957b0d50e,mint,1266112717,58391898,0,170,1324504785,2022-10-31
341b2da67d581ca2,at&t,286263164,39512633,61423,17651,325854871,2022-10-31
d2ef16e3ee9712bd,,150469433,2356923,0,0,152826356,2022-10-31
6415fa70a219c24f,mint,648867971,7215184,0,58,656083213,2022-10-31
3198811532efbf70,t-mobile,554648481,27280207,1364577,97292,583390557,2022-10-31
47d43e2bfdcc1a0e,,150122367,2823959,0,0,152946326,2022-10-31
20ea732f0277bf98,t-mobile,435870836,7888334,642059,26314,444427543,2022-10-31
59c8be84170fa906,mint,3732905563,51643628,2108746,998852,3787656789,2022-10-31
bfc24d6d114f11a1,mint,532307452,11481402,835464,122544,544746862,2022-10-31
f0ca033522209e25,mint,793070887,16949177,2092041,262709,812374814,2022-10-31
02c797213b359480,t-mobile,754338443,49846367,593905,118816,804897531,2022-10-31
b9d8b44015da3c39,at&t,1079975744,61018147,275323,81025,1141350239,2022-10-31
3cf83c0998a0bd66,,149648483,2843452,0,0,152491935,2022-10-31
eb5533efbb55fa9c,t-mobile,384443012,37713230,92354,30906,422279502,2022-10-31
3e324f756fafc524,xfinity mobile,1381894134,56786433,85772,221446,1438987785,2022-10-31
9fbf4b6583f8fd16,t-mobile,1038394861,89725581,0,0,1128120442,2022-10-31
3bac9d5c9e52580e,mint,517131389,57803174,2404038,390636,577729237,2022-10-31
d50507300cdc7014,at&t,654104813,77404717,1084442,219032,732813004,2022-10-31
15a878339c443a8e,at&t,858146406,73585208,1789515,272331,933793460,2022-10-31
b75493880aab3334,verizon ,18911411209,142136752,691200,57904,19054297065,2022-10-31
d2d8e35e0f212721,verizon ,474052355,35988788,649641,33966,510724750,2022-10-31
e092db4938f1a8f4,mint,670480904,58837283,1900359,259764,731478310,2022-10-31
5d21c5316828047f,at&t,1504465453,84449772,282337,110744,1589308306,2022-10-31
3e5e8f3902b88411,t-mobile,195196618,25789382,2028856,312578,223327434,2022-10-31
f498e3c8efa4e01d,verizon ,16337610329,278690008,1313410,86324,16617700071,2022-10-31
5dc34e97b596b225,mint,483716411,44458072,6621,1753,528182857,2022-10-31
4703b5705bd65ae2,verizon ,1977475489,55443259,17020,10109,2032945877,2022-10-31
aeb9b5674f24aea4,,506739820,35509567,0,0,542249387,2022-10-31
bb8108104a0906b7,t-mobile,570473554,21947604,640780,34821,593096759,2022-10-31
0cb31326d981bdaa,,162493341,2858940,0,0,165352281,2022-10-31
b60da9d7dcad5dc3,mint,2391136275,30983219,602129,69398,2422791021,2022-10-31
cf478e5cfaa7561b,,40581909,912795,0,0,41494704,2022-10-31
2a262ca718c380aa,mint,639355944,38168935,492,9759,677535130,2022-10-31
e2594b71fb18d780,,156461948,2959474,0,0,159421422,2022-10-31
8130b783519ace4f,mint,922713956,47969029,1300293,104522,972087800,2022-10-31
486dfaf366a9bd4a,t-mobile,558670501,57181110,8911,3433,615863955,2022-10-31
5e9864637d93f838,,125979326,4135334,0,0,130114660,2022-10-31
8c1c692795b6d737,truconnect,6797978746,203087482,964139,149938,7002180305,2022-10-31
615f48a3387ef641,verizon ,2139579259,79813119,1032733,118705,2220543816,2022-10-31
dcedc16c789a0030,t-mobile,1016543974,65695676,105050,40034,1082384734,2022-10-31
86a6f60d1256c242,mint,859716065,60314617,239114,69769,920339565,2022-10-31
4dd15b90d3c70d69,verizon ,257088266,17043697,76816,23007,274231786,2022-10-31
08b8d526f6bc9bb7,,161888950,4863691,0,0,166752641,2022-10-31
b18238437b33b35b,mint,5800630926,111233743,1744115,220092,5913828876,2022-10-31
71d256c2c0c339d9,verizon ,7914273692,147517584,205871,62765,8062059912,2022-10-31
3b652a45cc9b50d9,roam,3380507727,64634656,6493,1679,3445150555,2022-10-31
32319f84416c2abf,,154820177,2731574,0,0,157551751,2022-10-31
c6c68ba6bfca87e9,,154354214,1677521,0,0,156031735,2022-10-31
8b8562d3ea2348b4,,154501877,1976492,0,0,156478369,2022-10-31
16a3fb98924314f1,,155139385,1893301,0,0,157032686,2022-10-31
f81d96625b3a6b7c,,161467567,1546962,0,0,163014529,2022-10-31
9dfa4f2f4ded93e9,,154972441,1501038,0,0,156473479,2022-10-31
25952b1c7d242d7e,,154195893,3126788,0,0,157322681,2022-10-31
701934709ccf6d38,,183320128,1684781,0,0,185004909,2022-10-31
31b5fe871b30ff5b,,246564196,3228677,0,0,249792873,2022-10-31
e9251b49af1de629,,616106318,20875717,29367,8715,637020117,2022-10-31
76541b0cdf66852a,,175421864,2086617,0,0,177508481,2022-10-31
b6354892c16d6b03,,187502076,5332031,0,0,192834107,2022-10-31
de6fd04f2aa24a02,mint,646349607,16913661,561126,96981,663921375,2022-10-31
58149e759a0e254b,t-mobile,4968888446,110318443,1191991,210184,5080609064,2022-10-31
0943703e060b364d,,1445175574,28486100,10699830,791589,1485153093,2022-10-31
d71f8b421352db57,,46552848,1908627,0,0,48461475,2022-10-31
cdd235433efce071,verizon ,4325273984,114214403,36739,10924,4439536050,2022-10-31
1c3eb30ff4f2900e,mint,683391568,25275687,0,0,708667255,2022-10-31
5cb71a3b560a155a,,371840959,3312092,0,0,375153051,2022-10-31
d28cd96c73872232,,172469271,2970402,0,0,175439673,2022-10-31
2fbace3800284cb2,,75872367,1651665,0,0,77524032,2022-10-31
437aaefa3a48b0bd,,192237083,3543691,0,0,195780774,2022-10-31
638bae142acf01ad,mint,1830431020,57231502,647800,21665,1888331987,2022-10-31
6a638602678903f0,t-mobile,3601193159,38575358,10015,3035,3639781567,2022-10-31
982c02a742a15488,,45284100,1806015,0,0,47090115,2022-10-31
b5f8ff4333956d98,,195075056,5257422,0,0,200332478,2022-10-31
3bc53128b1323f6c,,179772910,2016961,0,0,181789871,2022-10-31
8b53f28e740c4cce,,189067383,2167970,0,0,191235353,2022-10-31
491c2b821fa9184f,t-mobile,630511593,57951403,840114,111610,689414720,2022-10-31
87059c3887e3bbb6,,619358,227638,0,0,846996,2022-10-31
93ba783b58da50a9,,874206,259491,0,0,1133697,2022-10-31
0d1e812346eb227a,home,153590,254675,9251,2432,419948,2022-10-31
7eec6ac1a6d8adf1,mint,8628,2270,0,0,10898,2022-10-31
9bc73113b4776d7e,mint,828267,214580,42602,19478,1104927,2022-10-31
6a5abae35d46358d,t-mobile,791185522,11377320,0,0,802562842,2022-10-31
87fa775ccb62cd6d,,22521969413,354382364,0,0,22876351777,2022-10-31
22ad98cd045cd9a6,,725183933,44750822,375244,128805,770438804,2022-10-31
67085c2dbf147666,,552815083,27843302,52747,139053,580850185,2022-10-31
c423a5ae7ee1c39f,,866425,309294,82430,32585,1290734,2022-10-31
5c0418b188520487,home,829234,279064,76610,29018,1213926,2022-10-31
a31177f4cc2c457d,,25976,112581,104,104,138765,2022-10-31
665ce5d60cfba7e6,,683950,218284,0,0,902234,2022-10-31
32b2a8a0d975717d,,41515441,4017780,0,0,45533221,2022-10-31
bed46131dc00fd88,mint,1736552724,109786226,48885,16300,1846404135,2022-10-31
f6ede06d64e5ac93,at&t,72517,21460,137576,197197,428750,2022-10-31
f6ecc6f7843db947,mint,707066046,39217780,0,340,746284166,2022-10-31
89553f16892488fe,verizon ,7080947975,128245675,634199,40102,7209867951,2022-10-31
e1488612532f5ffd,telekom.de,0,0,0,0,0,2022-10-31
13fa2a68e5da7141,verizon ,182337,65455,204714102,2920605,207882499,2022-10-31
fc92357467c6432b,verizon ,24090403,4598571,1414050,295989,30399013,2022-10-31
3678dbf9fc900d83,t-mobile,51500893,893956,621094,199168,53215111,2022-10-31
015c1c02f56b3e8f,tello,21088,8106,0,0,29194,2022-10-31
b486fcd98b00d8ca,red pocket,1878175386,63628132,634022,25645,1942463185,2022-10-31
a26c2947d2c821e7,verizon ,263724190,5654180,84,84,269378538,2022-10-31
43cd500bd84c93f4,,266180487,4219624,0,0,270400111,2022-10-31
f26af4cf8825ad80,mint,643963734,50186490,0,0,694150224,2022-10-31
37cbdf6d09777063,mint,940886,322221,0,0,1263107,2022-10-31
bd085ecc93151048,verizon ,1732342,261223,889686,152573,3035824,2022-10-31
42c800950e2c0fd1,mint,1337194694,18187812,0,0,1355382506,2022-10-31
3afeb013cc3638f7,,902736,255735,869348,274673,2302492,2022-10-31
67fff535aec3cc08,,334297153,13821860,6935,2212,348128160,2022-10-31
ca6dfd0ad21db120,,914200,308163,0,0,1222363,2022-10-31
4259de4188038106,mint,0,0,0,0,0,2022-10-31
502ddc2129fb2b8d,t-mobile,689482,211687,0,200,901369,2022-10-31
c5891e0c832e26ae,mint,970314041,17101808,15645,4928,987436422,2022-10-31
48a9c4031ab4a9c7,t-mobile,935037500,78545059,226888,118335,1013927782,2022-10-31
b1e82ed3f18bac62,pure talk,19729,7139,724928,218861,970657,2022-10-31
30d3a88162c39b2f,mint,1834,2173,0,0,4007,2022-10-31
53bedac6d1a101c5,,2777,42789,0,0,45566,2022-10-31
d9c2a2055621292c,t-mobile,835030,282285,209485,190825,1517625,2022-10-31
6468d8a6c1704d1a,,155269000,2867791,0,0,158136791,2022-10-31
3143e17857523ed4,,100042642,1738745,28016,14894,101824297,2022-10-31
8a9e7e99013e0538,mint,279712955,19236593,1358750,243310,300551608,2022-10-31
48817a41b63c02c9,home,848392,286409,216269,81876,1432946,2022-10-31
47abdb684f54aee0,mint,708759,252327,18289,6115,985490,2022-10-31
56ff2c1ee93b4bf3,t-mobile,745528,280440,350422,135136,1511526,2022-10-31
a6525657bbd8352e,mint,476160,295824,13580,3752,789316,2022-10-31
576ba2ce06a63198,,581426,508669,7028,2483,1099606,2022-10-31
f4c8934f88f4419e,verizon ,0,0,580641,46265,626906,2022-10-31
89e2fda7dc519dae,t-mobile,384286332,26441520,7153,2440,410737445,2022-10-31
5e268d7c430fb450,mint,790346,205508,89460,20621,1105935,2022-10-31
d62a19ca7ada41b5,,19888419,504211,9108,2352,20404090,2022-10-31
5c2877c010e168a6,mint,334090308,36866504,2195534,381935,373534281,2022-10-31
20e9e31aeb0250bd,mint,133187354,19579384,441425,162648,153370811,2022-10-31
ce5ba2232c22125b,mint,558421858,54842370,17973,6369,613288570,2022-10-31
ac6ac7621d7a1644,t-mobile,102197,69457,408039,141244,720937,2022-10-31
c8c17575fa68f0c0,mint,562681105,11838676,165564,54172,574739517,2022-10-31
dc859e90c57fe598,t-mobile,473897446,65107809,3368575,1096844,543470674,2022-10-31
13cbf2cdd23400a8,mint,23872016,404179,477086,127276,24880557,2022-10-31
c73179e07aa77fce,mint,429258527,9923357,0,0,439181884,2022-10-31
18d6293308ff26e5,mint,835202555,71232719,251043,97412,906783729,2022-10-31
7576422f88cfc71d,t-mobile,773076,209429,167442,58159,1208106,2022-10-31
c8d6592e2404568d,t-mobile,433415128,36812050,1944445,623255,472794878,2022-10-31
bb756dcc92415339,at&t,614721357,16034426,0,0,630755783,2022-10-31
08c306d40b99c763,mint,50208748,873978,492,7171,51090389,2022-10-31
b1a6e8c1aebd0055,t-mobile,51876069,979702,212287,80286,53148344,2022-10-31
078f0b0d418e8d97,mint,1114296785,50715746,2702952,1018400,1168733883,2022-10-31
50eb1894dc464662,mint,399122228,13948090,28195,9154,413107667,2022-10-31
6001ed6a2e5bf404,mint,645000816,19121476,111178,49994,664283464,2022-10-31
5ff4c6fb61d40293,t-mobile,639372909,63527712,961766,154268,704016655,2022-10-31
560de567557b1ad9,,551538563,42247463,1554019,322099,595662144,2022-10-31
08426a953d0ff6cb,t-mobile,389677378,26737959,502735,41866,416959938,2022-10-31
4b0d14784a294232,,27875,8145,0,0,36020,2022-10-31
046803da0cb33818,mint,632773,171477,0,0,804250,2022-10-31
aa0564d0ab278e59,,12314348,422235,7343,1688,12745614,2022-10-31
a0f6042491d1dc1a,mint,528861818,43586411,0,0,572448229,2022-10-31
2d39e82d3c12c5b6,t-mobile,470596408,40009968,0,0,510606376,2022-10-31
a5735d101ca0bc38,mint,49798393,1061668,0,0,50860061,2022-10-31
e24b75a36de30e26,,503291612,6070960,4793,41656,509409021,2022-10-31
ad9468ca81394d68,t-mobile,377530,105466,172962,73535,729493,2022-10-31
79d4027b2ec891f0,mint,8119164407,169255423,6853,2199,8288428882,2022-10-31
d9c101627b87fa04,mint,271685352,13351211,57857,23546,285117966,2022-10-31
d89dc0734c1e2edf,mint,4048192499,120174017,1218296,298977,4169883789,2022-10-31
8fe0bccce5fc0ab5,,20876,6095,760506,272776,1060253,2022-10-31
2d573e4926493753,mint,837370613,74602546,0,0,911973159,2022-10-31
2c0e94c1ce4c0455,,118578203,3860111,0,0,122438314,2022-10-31
2a8a836ceed217db,t-mobile,1529176694,106208504,0,340,1635385538,2022-10-31
43dc0d2217ce81bd,t-mobile,199370,74060,0,0,273430,2022-10-31
5e5d496521f2c089,mint,69484059,709193,245183,73306,70511741,2022-10-31
64ad6fdbd60f1f05,,873161,278842,0,0,1152003,2022-10-31
26bdeb8e85b1268a,,17931,3843,0,0,21774,2022-10-31
18f66898f87e2ffa,,1098174,222916,0,0,1321090,2022-10-31
5d6a02ab1e814d27,,5242448638,105418641,0,0,5347867279,2022-10-31
58d9d7805a9770fb,,430575199,8353342,0,0,438928541,2022-10-31
ae80601d80db1e08,t-mobile,243888324,24767708,635472,32564,269324068,2022-10-31
0a160d10ea7a8934,mint,45293,9037,0,0,54330,2022-10-31
c2826ddf88566458,t-mobile,464671487,24420179,6493,1679,489099838,2022-10-31
4bcf5484776febc1,mint,19677315,1230360,0,0,20907675,2022-10-31
30e44c8376e9bfc5,at&t,129399981,2352378,1685580,216834,133654773,2022-10-31
f597f51afd815e9c,,189644923,4360290,0,0,194005213,2022-10-31
7d09d0534fb661aa,,59568632,2319883,0,0,61888515,2022-10-31
ea94d86057107832,,172775708,5352801,0,0,178128509,2022-10-31
ae593e9f176c45ca,,235796713,4716865,0,0,240513578,2022-11-30
79169658f899d821,t-mobile,0,0,0,0,0,2022-11-30
34e5ecaf77d3da4c,t-mobile,0,0,0,0,0,2022-11-30
7d9325b48971f8c5,,515583,133592,934637,300916,1884728,2022-11-30
7383b97d029ecba3,Verizon Wireless,0,0,0,0,0,2022-11-30
8ccdb40354711f80,t-mobile,0,0,0,0,0,2022-11-30
699691e9446834fc,Verizon ,14711632149,347949121,219574,81718,15059882562,2022-11-30
193d8e2fd2bc7c1d,verizon ,63472,20791,1009617,399848,1493728,2022-11-30
b365c91680c07736,verizon ,1541708344,37518149,1086230,170614,1580483337,2022-11-30
16bcf66203b3a874,t-mobile,786565,276872,96286,31982,1191705,2022-11-30
485d08f3e77491ac,home,767501,215933,170937,149354,1303725,2022-11-30
8de4bb4c90b8b4e0,t-mobile,112379166,1719414,4453068,678986,119230634,2022-11-30
ac9a47b9696700ac,,224497136,3428451,33114381,466337,261506305,2022-11-30
7dfa3918c34ad8c4,metro by t-mobile,0,0,324253,79492,403745,2022-11-30
94cc918c7a7209d2,,22258,7106,0,0,29364,2022-11-30
da611688e597dee5,,143979,50635,0,0,194614,2022-11-30
88a597ccbdf36445,,567586881,15395723,0,0,582982604,2022-11-30
e508f58548138e96,t-mobile,872952,233848,225537,68195,1400532,2022-11-30
2727a78261a3df0c,,962226,264263,346173,123659,1696321,2022-11-30
8a5e6350e6443b3b,t-mobile,81562,33536,13250968,938784,14304850,2022-11-30
a6667f189144deb9,,1579479627,29063700,0,0,1608543327,2022-11-30
e15e3ba18c082f17,t-mobile,11826553285,201039374,1124529,200652,12028917840,2022-11-30
cff1f1bef9468454,,892392,265184,578074,211012,1946662,2022-11-30
2745a170212caad7,t-mobile,754057573,11658905,0,656,765717134,2022-11-30
b8bc191fa6308ad4,t-mobile,81134059,2958411,12814,125804,84231088,2022-11-30
a591c716db3b397c,t-mobile,0,0,0,0,0,2022-11-30
533cdc21f670fc5f,t-mobile,0,0,0,0,0,2022-11-30
a2bc50818147915d,t-mobile,639293531,26169078,987783,166935,666617327,2022-11-30
0f894d9caead800f,t-mobile,0,0,0,0,0,2022-11-30
25df0e64a3fecff6,t-mobile,0,0,0,0,0,2022-11-30
314cd9d22b61cf3e,,299425542,50524167,986772,221368,351157849,2022-11-30
0da93729c76fadbf,mint,1466345624,38101657,13819,9244,1504470344,2022-11-30
0ec59b120a79cc9d,t-mobile,622928630,35383581,879896,148881,659340988,2022-11-30
3807433fe6354385,,584408533,55113408,14967,4316,639541224,2022-11-30
0f1157f806a154fd,t-mobile,0,0,0,0,0,2022-11-30
e01b0c11b42ee63f,,26770000,4306597,0,0,31076597,2022-11-30
9c3bfae0b25612de,,62457,16201,0,0,78658,2022-11-30
818858979ca3ec15,t-mobile,75677902,8732995,0,0,84410897,2022-11-30
044e5b6346cc390f,t-mobile,678654413,11219819,123202467,1571242,814647941,2022-11-30
fbf4457e5b9cc1d2,t-mobile,0,0,0,0,0,2022-11-30
ecc46727a8c39a9b,,107299987,7461708,0,0,114761695,2022-11-30
b75950944fc3684b,verizon ,281541198,4375570,176971795,3960135,466848698,2022-11-30
c79ef07ce1c4271d,,727946066,33867392,0,0,761813458,2022-11-30
aa5046055772fb2d,,537375242,10005752,0,0,547380994,2022-11-30
7083dbd0b6329f94,t-mobile,580597904,27237156,14955,5134,607855149,2022-11-30
4bb6e1e195b1ddf1,Verizon,0,0,0,0,0,2022-11-30
a7fc457b3bdde10b,t-mobile,0,0,0,0,0,2022-11-30
9f04ed3908ac4a05,t-mobile,806191,279019,955468,329354,2370032,2022-11-30
b2905113034c3c03,verizon ,102575467,1575278,491917,145414,104788076,2022-11-30
d6019ca9fe0498c9,cc network,0,0,0,0,0,2022-11-30
e993d9a55d0ed2a4,t-mobile,388828267,21967817,6863,2212,410805159,2022-11-30
3ee6e7da32f7f0ba,t-mobile,53406,30035,235389,74548,393378,2022-11-30
8ae80c5fb720acd6,at&t,0,0,0,0,0,2022-11-30
bb274fc758f5ec84,,823888,291650,0,0,1115538,2022-11-30
0c12f12679b81c75,,383491446,6112614,0,0,389604060,2022-11-30
346ba3e4fafd42f1,t-mobile,0,0,0,0,0,2022-11-30
cffd44c9fae049f0,,12395954474,235287046,0,0,12631241520,2022-11-30
45385b78cd6e6598,,370066798,34309806,29592,18673,404424869,2022-11-30
cff4ee9f74635839,,773362444,13315983,0,0,786678427,2022-11-30
0c674fe0423d1ba5,,2279501576,37211128,0,0,2316712704,2022-11-30
f2d8386eadb65360,verizon ,0,0,234148,76488,310636,2022-11-30
532ff64d966e3a34,t-mobile,251497358,15866758,387,6024,267370527,2022-11-30
625b97abe2cfc5b1,,445814667,36049903,36073,11543,481912186,2022-11-30
abf005ef005c426b,,119172019,2385910,6964,2597,121567490,2022-11-30
6855c1d40ec079a7,t-mobile,518537009,12056754,31230,12990,530637983,2022-11-30
1f78a28c9da8a46d,verizon ,5619872,409251,132913634,2199914,141142671,2022-11-30
07f7f51e000a9df3,,594171,163975,0,0,758146,2022-11-30
d1dca2a1fbc9ab8c,t-mobile,536635214,59286634,93,110,595922051,2022-11-30
c90c7e116ae49f08,mint,774848912,67595634,1184206,242119,843870871,2022-11-30
46fe7fc84b5bf6e2,t-mobile,846934026,46430164,13800,4317,893382307,2022-11-30
80d43e261fa7a938,t-mobile,546426703,62466872,20479919,611434,629984928,2022-11-30
1757e4eee59b9d9d,t-mobile,890210,237167,93004,18171,1238552,2022-11-30
de52a0522cf8d999,t-mobile,466703070,63863813,218929,89608,530875420,2022-11-30
d33ed229479a29c3,,4371319878,116137842,7116,2421,4487467257,2022-11-30
3a41ec714b5e9ff4,t-mobile,1124544411,55231692,13869,4214,1179794186,2022-11-30
daa2195bd360d89a,t-mobile,795847,270596,16035,5773,1088251,2022-11-30
f0e79d817ed1d9c5,cricket,1512873,309784,63356,17909,1903922,2022-11-30
3cb9e3346fcef08c,,651728,183884,0,0,835612,2022-11-30
7847151908c2127c,verizon ,0,0,1753882,196443,1950325,2022-11-30
508adb081dc9c5b5,at&t,38640503,755720,16020,3564,39415807,2022-11-30
1d68f8ef0342ee5c,t-mobile,543625105,6468015,8853,3445,550105418,2022-11-30
150eefd40c402d55,at&t,17163,7641,0,0,24804,2022-11-30
e04a5d0fd076df1f,t-mobile,445149242,32075160,29226,10486,477264114,2022-11-30
f4a1f80776b98e19,t-mobile,0,0,0,0,0,2022-11-30
7e3a085113324ef9,,826478238,18572457,0,0,845050695,2022-11-30
d15aecd5674cbfa0,mint,63767424,1044990,1080709,445237,66338360,2022-11-30
9eef99b649df8409,mint,949449983,84598332,198174,79905,1034326394,2022-11-30
4f0ddad05d9bcdbc,,220118,110409,0,0,330527,2022-11-30
2a71ee81611eea9f,metro by t-mobile,188965406,2706541,29439,12673,191714059,2022-11-30
93613d922c31f1bd,,726162,209078,0,0,935240,2022-11-30
c0e76a8962b2221c,,106214365,17447170,0,0,123661535,2022-11-30
2e7764326e41a686,verizon ,252732081,4105256,169437,71074,257077848,2022-11-30
c2a426211cf2cfaf,mint,0,0,0,0,0,2022-11-30
03f3f69201daab15,t-mobile,94716759253,1194009781,0,0,95910769034,2022-11-30
10f4617370573c69,verizon ,0,0,49730,12674,62404,2022-11-30
e571a5612c5d5f70,verizon ,6385914,185790,3260034,110111,9941849,2022-11-30
6cace4a0ca91696b,t-mobile,9330136,2233708,127119,31493,11722456,2022-10-31
1d0f66340722a9a7,metro by t-mobile,734744746,9758182,17425,4943,744525296,2022-10-31
503c6c1320872ff4,,246983885,2663072,60903538,1281844,311832339,2022-10-31
308876864d7617c9,t-mobile,693337,188732,518555,165420,1566044,2022-10-31
23bdf68e90060d6e,,19803539,1225585,0,0,21029124,2022-10-31
52e442107bd0a710,,1685383442,20957603,0,0,1706341045,2022-10-31
09a9bed6c25411d4,mint,1504275181,59988469,0,0,1564263650,2022-10-31
32b7f83e8ca653b5,ting,484278424,23730133,364521,133607,508506685,2022-10-31
d33cf871d2fa0982,t-mobile,569798,153112,161779,62243,946932,2022-10-31
8d0c5f65bee49cf1,,781013151,12388988,0,0,793402139,2022-10-31
051937fd5d998c43,mint,1056604016,28249261,679652,164896,1085697825,2022-10-31
0874bae29cced3b3,,243028441,36465567,100257,44970,279639235,2022-10-31
9192ba448a6e87b9,mint,457720297,53587462,1316494,285293,512909546,2022-10-31
4c8a854f848b3f24,mint,52860542,1975992,370809,154219,55361562,2022-10-31
41036cdae48c179e,mint,657111227,70168000,80198,27458,727386883,2022-10-31
5bb4f10c61bc563c,mint,123721403,9197114,1298559,91881,134308957,2022-10-31
5be1b9c435cf308e,mint,1114297469,77827094,106948,38595,1192270106,2022-10-31
97be162fe8505d6b,,870453001,71452718,504405,34696,942444820,2022-10-31
6621a2c067b7cf45,,575616171,49697457,0,0,625313628,2022-10-31
d7ddd749e11f81ac,mint,1539542,294645,103491,37876,1975554,2022-10-31
750dfdf612566b92,,324315,106946,0,0,431261,2022-10-31
f743a01663b67e7e,t-mobile,1077552857,76934266,34272,10219,1154531614,2022-10-31
7128227fa7e5de12,mint,1121598362,58948213,260281,117036,1180923892,2022-10-31
e928b2601b92a9f6,mint,662805325,59933454,285674,98634,723123087,2022-10-31
0b2ee051e7ec20b7,public mobile,140315483,11358306,0,0,151673789,2022-10-31
4506388001d68039,t-mobile,1566516448,89881219,1569772,294160,1658261599,2022-10-31
7876dc8beb834cd5,t-mobile,4378909566,108083775,135662,41770,4487170773,2022-10-31
4f524758be006769,t-mobile,845051604,84713139,0,0,929764743,2022-10-31
1d2d4d2f4898c791,at&t,637564817,52318535,49235,17708,689950295,2022-10-31
51b683fb7a782fe0,at&t,1181569522,58821274,0,135,1240390931,2022-10-31
ef70b34d34bfd2b9,at&t,781763137,73591949,1086629,195457,856637172,2022-10-31
e5398e2550c47de0,verizon ,740334041,70925020,1285776,433062,812977899,2022-10-31
840bb215da9c10c8,verizon ,2866483134,93064441,39215,19289,2959606079,2022-10-31
76b7e768485eb072,at&t,68820155,10127234,1313240,147478,80408107,2022-10-31
539d363bc8e2373a,verizon ,638410932,56761672,745614,76322,695994540,2022-10-31
85ed008ae1cb86f8,verizon ,666748393,72311145,815425,79497,739954460,2022-10-31
14f91567bfcdf2ca,at&t,766463600,61494983,6758,1701,827967042,2022-10-31
297cae86e1c9e41f,mint,5635567270,116713907,16650,114793,5752412620,2022-10-31
5933d02f5b3bb71c,mint,531024432,12869198,0,0,543893630,2022-10-31
70b61c9f1596de04,mint,409219754,26164611,155896,54518,435594779,2022-10-31
9a547040a304e976,mint,161220517,16286800,0,85,177507402,2022-10-31
48d0b6dfbaa9ca93,mint,73880575,1178763,53269435,1917717,130246490,2022-10-31
4fe3ff40fec9c21a,mint,416664143,13105264,0,0,429769407,2022-10-31
a2b8af439f24c422,mint,1015178047,52078992,6493,1679,1067265211,2022-10-31
678550c038b901be,mint,1337717888,81856656,317083,104213,1419995840,2022-10-31
fb5173ca13781bfc,t-mobile,101061754,1735377,16496,193646,103007273,2022-10-31
d4910043ef54ef52,t-mobile,664080,187741,0,1110,852931,2022-10-31
d873d830f533ad6a,mint,568124,144384,435556,128893,1276957,2022-10-31
4e94db23113a2942,mint,1628320282,117338533,265250,103623,1746027688,2022-10-31
76c03ae66d37c53d,mint,615354102,17859312,0,0,633213414,2022-10-31
7cf4e0453a0ba1e1,mint,451456290,37551977,816667,112080,489937014,2022-10-31
5514d68e3cd23bbf,,144003091,2950253,0,0,146953344,2022-10-31
42086b8f8cb8a105,mint,310481264,11878710,1577045,669802,324606821,2022-10-31
b1ab95604bcaad33,t-mobile,989670650,56221174,1296625,77997,1047266446,2022-10-31
8d37eed32815e562,,54225241,794214,0,0,55019455,2022-10-31
3f31e27ad07d7f49,at&t,956125387,92140874,9645,6599,1048282505,2022-10-31
e2d1c4212ad56d28,at&t,1531270247,55808130,0,135,1587078512,2022-10-31
ea0c715b3e95efb0,mint,889496694,65365060,6673,1756,954870183,2022-10-31
5db67a0614c8a162,mint,534980482,55105858,173140,59198,590318678,2022-10-31
860f14bdd84d90c8,verizon ,88018029,1255390,1599896,292341,91165656,2022-10-31
f689c675994a84f1,verizon ,849355055,73940142,0,0,923295197,2022-10-31
18f9459207140509,verizon ,791600289,24350155,1440112,155846,817546402,2022-10-31
cddb901b7f75c18a,at&t,3524954047,100253237,193260,92507,3625493051,2022-10-31
c77d705478b9528a,verizon ,333237597,48652933,855835,94536,382840901,2022-10-31
3f856a3a05089883,t-mobile,925368530,58847241,984723,142978,985343472,2022-10-31
dfe1461b083e95a3,,235293418,40119747,628823,59782,276101770,2022-10-31
5dca5f46afe590bc,xfinity mobile,190282079,22977257,267,142,213259745,2022-10-31
97f5099448e97293,verizon ,2755911954,79972228,5640,1859,2835891681,2022-10-31
1ee5c999999e316f,at&t,463412583,43723088,27936,8275,507171882,2022-10-31
148a9f295c22e2c9,verizon ,590233317,34270715,1647570,280349,626431951,2022-10-31
489c963d8a68cddd,mint,302456670,34273389,1296190,192668,338218917,2022-10-31
6b95a59fbd5c0762,verizon ,382927,1376471,4961,96307,1860666,2022-10-31
01e8a06f91f233af,mint,381617352,29673603,435836,133051,411859842,2022-10-31
1a9ef237baae7850,mint,982886337,73720237,804750,85326,1057496650,2022-10-31
5260d8c61c229370,mint,633338962,60803149,6876,2545,694151532,2022-10-31
482e92d9acf48a4f,verizon ,728518,291893,0,9092,1029503,2022-10-31
a57d0bfce646cb48,at&t,35238,220401,34792,8975,299406,2022-10-31
329e7c1ab9338a69,at&t,482468956,40796489,2031173,332324,525628942,2022-10-31
e1be2c9676445404,mint,1055347323,59213522,671723,60706,1115293274,2022-10-31
956dc584a6ce4693,at&t,553572,162017,74889,27087,817565,2022-10-31
b008bde5dde88dd1,,852502157,25372796,570740,33544,878479237,2022-10-31
62b2c851170d3c55,verizon ,234131243,11327796,807765,125551,246392355,2022-10-31
b6f4869da706b409,verizon ,690953166,77416221,19098021,644874,788112282,2022-10-31
30d0a593ca929b7d,at&t,0,0,1736537,262490,1999027,2022-10-31
48ed424aa0ac8cae,verizon ,364959356,16405857,798,6726,381372737,2022-10-31
3de8f8347e90262b,t-mobile,749838514,62822425,95039,36665,812792643,2022-10-31
dd841543205a2889,t-mobile,1054231624,67193042,1671240,461177,1123557083,2022-10-31
7ffc578fd201ed49,mint,1509952693,62755881,88384,31520,1572828478,2022-10-31
67681b0ea6acd5c4,mint,789118347,34115695,732413,55951,824022406,2022-10-31
9ddf461b28befa0f,us  mobile,2069403033,94739243,107155,41324,2164290755,2022-10-31
6da3eed6eb2d5671,mint,771975603,10556079,1734324,232071,784498077,2022-10-31
cec0263e0021faa8,,405548225,14824488,6256492,931321,427560526,2022-10-31
3bc835fa432aea92,mint,251603932,12452326,530257,158152,264744667,2022-10-31
f2ecca23441b6b33,t-mobile,180628,44558,0,0,225186,2022-10-31
c5c0766ef661a475,t-mobile,39041,11733,533705,289678,874157,2022-10-31
e83e929fd331ba0c,t-mobile,461895211,53811928,171810,58671,515937620,2022-10-31
c534deff1b9f3020,t-mobile,224542154,18850485,247465,89025,243729129,2022-10-31
db5bd4a7b4ced21f,mint,331854693,4568239,0,0,336422932,2022-10-31
a062aa2465d83b3f,mint,675413330,28808773,877168,103028,705202299,2022-10-31
b2b97eec180e5e1e,,11374254,331602,0,0,11705856,2022-10-31
80e60e6a789d8639,t-mobile,30211,18256,104,104,48675,2022-11-30
b385c21660904be2,mint,433367,147704,83500,31373,695944,2022-11-30
7775ea5b8fe8fd36,,34135,11812,0,0,45947,2022-11-30
6c8bc327c7741231,,784787,224447,30016,10235,1049485,2022-11-30
d0798d0ee8efe4c9,t-mobile,783315014,51462008,6935,2356,834786313,2022-11-30
15620e0456bf2475,,256652,67551,715866,259175,1299244,2022-11-30
0d812b1b4c31319e,,475159631,37052951,792499,84819,513089900,2022-11-30
86d578247e4629cf,us mobile,494430429,26296153,601057,41537,521369176,2022-11-30
045cf40834f1275d,mint,277833,110669,18753,6900,414155,2022-11-30
bf175ecac1812fca,,698691118,77392342,0,0,776083460,2022-11-30
8a6f39f55c20a34a,,905505,458889,66553,29941,1460888,2022-11-30
68f1fd74898596fa,mint,851790,241553,358157,121696,1573196,2022-11-30
d60c5c73832ae31a,,664611,196973,12549636,855377,14266597,2022-11-30
3377e915904148b1,cc network,672667241,24577685,1000064,212611,698457601,2022-11-30
34c73025e9445ac3,,21655,8773,0,0,30428,2022-11-30
1b52f2ff63328190,ting,1072141944,12999219,0,0,1085141163,2022-11-30
36035d18ec2fdcfc,mint,67331199,1724794,0,0,69055993,2022-11-30
8436dad2bc521297,verizon ,536904796,24264610,2043711,303872,563516989,2022-11-30
f889dabc14581cfa,mint,623496367,9225069,146194,45548,632913178,2022-11-30
dcd4d44e3338f174,mint,642121583,48889445,19998752,550753,711560533,2022-11-30
ef62485e7ab30bd9,,123,620,0,0,743,2022-11-30
ec9f045126580d7b,mint,711617633,50808747,1117475,177092,763720947,2022-11-30
911c8ef013a5ecd1,verizon ,75616598,9490027,40992,12222,85159839,2022-11-30
cf6b490637ec023f,,11357688,144632,0,0,11502320,2022-11-30
15529f3abb2ecd11,verizon ,0,0,36930,10261,47191,2022-11-30
11789a9202b210f2,verizon ,136998721,2320706,1175899,212546,140707872,2022-11-30
e63a2aaa50a37a98,mint,638731734,44837522,13726,4066,683587048,2022-11-30
7c4b25008e4154ca,mint,734321,266406,18930,6053,1025710,2022-11-30
37ea956407836913,verizon ,5789070528,96278295,1970912,460636,5887780371,2022-11-30
a0d950f9d4957d95,verizon ,7873622253,160519427,3018,110774,8034255472,2022-11-30
6235298bba0fb700,t-mobile,84,84,88343,121933,210444,2022-11-30
79a64f52b6a164d3,t-mobile,765947681,63241509,14393,4824,829208407,2022-11-30
5850baddb8b266b4,t-mobile,871947616,72380965,703973,49954,945082508,2022-11-30
8d03dd41f29d8b93,verizon ,573379004,19906695,0,84,593285783,2022-11-30
1ef80c758be629e7,,24487222,588135,0,0,25075357,2022-11-30
935676463c2b8bed,mint,746665,249545,11201,3358,1010769,2022-11-30
5264ac334fc1a8ac,,14856,4714,0,0,19570,2022-11-30
ab342f170468a4c0,,500483,158157,0,0,658640,2022-11-30
2d8670b7dd7b1b98,mint,46890,132503,104,104,179601,2022-11-30
cfa62766f7675640,mint,71083142,6731374,107082,38446,77960044,2022-11-30
6a1aff19b5c3f29b,at&t,587596,175865,302602,110263,1176326,2022-11-30
de09cc9971c5c471,mint,370462832,43731226,951899,130922,415276879,2022-11-30
9cc2a6332b38988e,t-mobile,540135593,41476543,13868,2435,581628439,2022-11-30
aaa324b67abb6313,mint,543996040,55866349,0,0,599862389,2022-11-30
cbdffc2610734911,,731600,206278,0,0,937878,2022-11-30
42bc2bd5905aeb3e,home,1179017219,75204444,28561,10291,1254260515,2022-11-30
3851d497d802fa6c,mint,860961,254556,522722,185469,1823708,2022-11-30
9984ecffe86d02ce,t-mobile,889500263,62759204,873177,147078,953279722,2022-11-30
bdc94638428e1692,verizon ,7817070811,187342681,110431,43913,8004567836,2022-11-30
91fed679ad8853d5,,1312482867,39122249,0,0,1351605116,2022-11-30
86208479ccd769bc,,16504166434,296904835,0,0,16801071269,2022-11-30
4716f016c5e62d64,,808864,268456,0,0,1077320,2022-11-30
2fc2b6416e4ed977,,13297,4544,0,0,17841,2022-11-30
a6bbaf28a216de6b,mint,678576208,61517851,1640597,214133,741948789,2022-11-30
726bc43d544b3347,,149514566,2897058,0,0,152411624,2022-11-30
4da84c967853992c,t-mobile,13302501,2382454,0,0,15684955,2022-11-30
62738c57929451d4,mint,427318110,14989377,133113,60080,442500680,2022-11-30
de99d3292ec87b17,verizon,1036924,356816,14644,4775,1413159,2022-11-30
fc671c1df98b3d91,at&t,0,0,705502,255741,961243,2022-11-30
061c14cc30ec7064,,240286052,22749651,418,330,263036451,2022-11-30
168af75edb5e9de1,t-mobile,315198385,25609838,21076,232850,341062149,2022-11-30
8adfebb9ebbb54ce,mint,481177032,25388620,498,1721,506567871,2022-11-30
671cec9af93b0c08,mint,51919543,1538935,4109,59719,53522306,2022-11-30
0bc76f35b1484dda,mint,37427773,6566263,0,0,43994036,2022-11-30
b13c8cea6ac2f6b4,mint,73680,16090,196088,143953,429811,2022-11-30
26a7341461f3fe76,,572047,261544,32943890,721463,34498944,2022-11-30
4eab2515061b367b,t-mobile,914452813,56579683,882930,129674,972045100,2022-11-30
1858c6a5d6c981ac,t-mobile,0,0,743309,252706,996015,2022-11-30
bb0106e7cbdf86fc,at&t,735778,370632,90064,31269,1227743,2022-11-30
4da441879d61f737,,991056234,23991886,307,4949,1015053376,2022-11-30
93728f74ed91e681,,195030985,11416159,0,0,206447144,2022-11-30
f4700b86ea94618c,t-mobile,600209102,22258773,104,104,622468083,2022-11-30
a4834fcfb2ddd148,at&t,831882,242307,187171,74122,1335482,2022-11-30
59c1d38f8169f4f8,mint,353185488,22203839,2949019,449614,378787960,2022-11-30
68bed055137febeb,mint,547189374,38096514,1171931,211581,586669400,2022-11-30
09c1a81ecf6e45f8,t-mobile,297161550,10698420,58467,33039,307951476,2022-11-30
75ac3d7f25550218,t-mobile,870923065,62373060,6863,2033,933305021,2022-11-30
17563b60e30ae378,t-mobile,0,0,95736728,2292596,98029324,2022-11-30
041537d3b0b6fb84,t-mobile,2200537425,66976038,1814217,287789,2269615469,2022-11-30
d569d95c95ca0ec1,metro by t-mobile,744609,210954,104,104,955771,2022-11-30
3b7c49b70ff48d92,mint,228724,99447,0,0,328171,2022-11-30
697de1af126e3fb6,mint,101834090,1553174,0,0,103387264,2022-11-30
16e451519adbc793,t-mobile,355682674,37458208,36014,10837,393187733,2022-11-30
a3e6d75535b0bb13,t-mobile,2287259983,80678883,1488093,239290,2369666249,2022-11-30
19ec2a821074bb7b,,699149260,35927465,0,0,735076725,2022-11-30
fa4fee084d6d5094,,5247135,108207,0,0,5355342,2022-11-30
79184448ad70e4c8,mint,664130357,44893860,11968,2526,709038711,2022-11-30
1980fa179973f7e7,mint,379377740,18611951,16085,3463,398009239,2022-11-30
f00c6e1453821d35,mint,1008130434,70242175,1596702,308119,1080277430,2022-11-30
2bf5d90c690f4087,mint,425843305,17979444,46586,29730,443899065,2022-11-30
842ed61a3b32a2ad,,643249,188750,0,0,831999,2022-11-30
e771256689e063fa,mint,0,0,1967278,686578,2653856,2022-11-30
30d937bc898aff6c,mint,479822555,31576914,0,0,511399469,2022-11-30
4cf2420efe254bdc,mint,604833710,75344848,1383629,75433,681637620,2022-11-30
1ed80ec46d9127ff,mint,36279,8764,2727,791,48561,2022-11-30
d1431197c23c9808,mint,304309,157933,63479,7564,533285,2022-11-30
d3503984d3c2213a,mint,20544537,1343908,0,0,21888445,2022-11-30
d3e3a63cc3892040,mint,372985069,41348925,1709846,188640,416232480,2022-11-30
2081459800ee6ad3,t-mobile,194059593,4011894,0,0,198071487,2022-11-30
b241b300a8cfe3a4,mint,4081122041,71346017,919611,129195,4153516864,2022-11-30
048ed1f1d5e4a3ff,t-mobile,450372,153974,19626,6721,630693,2022-10-31
62e3495a463fe033,,39628308,778383,0,0,40406691,2022-10-31
34e2b32d8013a991,mint,477722424,10171362,0,0,487893786,2022-10-31
59e1921707056c60,mint,735581,191819,318390,102008,1347798,2022-10-31
0cda80418136535b,at&t,14127527275,107590569,1002975,138321,14236259140,2022-10-31
74ddadf2e7601d4e,xfinity mobile,5554365785,86106901,1141476,188994,5641803156,2022-10-31
16ca1bb6a6e1fe27,verizon ,1171044499,67517961,1306027,86073,1239954560,2022-10-31
2dc8ba61d760565d,verizon ,921079839,67992126,977952,158283,990208200,2022-10-31
d7d18b5003a73586,verizon ,279359067,32292740,18907,6980,311677694,2022-10-31
e2048d4461ad4b82,verizon ,696905898,36394642,253540,9664,733563744,2022-10-31
b02dc128b16068aa,t-mobile,503769097,10438758,55285,19151,514282291,2022-10-31
6a6326b141650830,verizon ,632279643,63941836,828042,83734,697133255,2022-10-31
8a92223cce40380e,t-mobile,754426392,58468512,6565,1804,812903273,2022-10-31
3a95d4edb19651f2,at&t,440299949,22990982,1300902,120252,464712085,2022-10-31
5338ee29b5fb78d7,verizon ,151636110,20552989,35855,8885,172233839,2022-10-31
0befff53aa37dee6,mint,1703172723,79709048,1546183,59537,1784487491,2022-10-31
362592424f44dc7d,verizon ,0,0,7693,2588,10281,2022-10-31
6a00fe161113de0a,spectrum,3041215226,71566344,1002497,141029,3113925096,2022-10-31
bc259a6b980020c0,metro by t-mobile,857242676,21874857,947133,105392,880170058,2022-10-31
c806581a3e0df784,mint,1350439502,43563698,33520,6787,1394043507,2022-10-31
6fa9b3e5b93034c1,verizon ,2859838963,95262058,1350583,280452,2956732056,2022-10-31
17aaaf664b5f572a,verizon ,425995061,46246331,6886,1984,472250262,2022-10-31
c7abe506c6387465,t-mobile,700172668,40819294,1161687,214317,742367966,2022-10-31
f6ea15c3dfaeb9b3,verizon ,272002806,27327478,2042620,310829,301683733,2022-10-31
3aecd11b4033f2c5,at&t,0,0,78596814,383544,78980358,2022-10-31
0a536dafa9ae6200,mint,1115325881,67227127,2030366,590730,1185174104,2022-10-31
4e152de0da6dd7d8,mint,753734744,54079329,1366137,99249,809279459,2022-10-31
2bee853dc2062b7a,at&t,654471197,6213000,2299412,403162,663386771,2022-10-31
efe35939f92b4128,verizon ,444158525,26358751,13587,3400,470534263,2022-10-31
1aa606171ee7ab9c,at&t,3121740595,75314210,1977368,278709,3199310882,2022-10-31
b57e080aae7cef79,verizon ,141627282,1350622,901458,309107,144188469,2022-10-31
2b99e0c92dd6ead4,,927957658,18000858,21437302,263619,967659437,2022-10-31
39801657734d0be8,at&t,108905551,3241069,1323435,106420,113576475,2022-10-31
ba5cf4339bc9fb86,mint,986712432,85677023,1906784,409063,1074705302,2022-10-31
569c509c240cef16,t-mobile,710026620,54286433,6520,1847,764321420,2022-10-31
f8f0cc9e610e4b20,t-mobile,1006954543,22507640,658497,49734,1030170414,2022-10-31
6b0a1ac2db8b7d5c,mint,591971174,20768219,178314,62701,612980408,2022-10-31
51aa2ea246e56c8b,t-mobile,0,0,2129567,282118,2411685,2022-10-31
7e0e4dfa29c6f33b,mint,1429200,240491,36537,25883,1732111,2022-10-31
229ce6058e271a25,t-mobile,620942801,55829984,989857,135606,677898248,2022-10-31
a98e518f3391fe52,t-mobile,324956685,7408947,703681,54307,333123620,2022-10-31
bebf8173b7a8dc7e,mint,21706810363,326704263,1035725,187017,22034737368,2022-10-31
551ec0a8fbd2f283,mint,142313,297630,923516,144714,1508173,2022-10-31
0f1ac810f3c69577,,25157242,5174485,0,0,30331727,2022-10-31
b0c9b610231b2a48,mint,647591795,19741972,0,26,667333793,2022-10-31
5275e8b2a7239e00,t-mobile,958273634,73924079,2172657,310191,1034680561,2022-10-31
1e5d4303e4b57611,mint,465887788,30154834,550966,51581,496645169,2022-10-31
bb0b8d27e32e1f64,,228829757,1754825,0,0,230584582,2022-10-31
27195c08e00a2a64,mint,85701101,15998224,1625272,504750,103829347,2022-10-31
4b15f5bb38d8b46c,t-mobile,561971053,54679672,45092,11787,616707604,2022-10-31
00ae78d85bc55409,metro by t-mobile,607,1303,82437,27355,111702,2022-10-31
da9b7c1fcaeb4fa1,t-mobile,79298100,9801550,84,84,89099818,2022-10-31
ebf58217a0d5b04f,mint,0,0,31325,11261,42586,2022-10-31
34c12e45caf32844,,719385477,27605370,688225,45873,747724945,2022-10-31
b0f1ae559e4f4c08,t-mobile,485390,48453,7598,1759,543200,2022-10-31
7651297c5f92543f,mint,2976598798,60805870,396412,49144,3037850224,2022-10-31
5cf911db7fb0475e,t-mobile,1365579842,25706268,105775,40738,1391432623,2022-10-31
e01a5bde68210e27,,6566200510,69538311,0,0,6635738821,2022-10-31
eb872fbbcb4dca99,t-mobile,2432565707,81232147,60677,22370,2513880901,2022-10-31
d80bd8a7482a7386,mint,119534404,9059474,0,0,128593878,2022-10-31
77387ddf616aa1ff,t-mobile,214652651,3454776,140394,153810,218401631,2022-10-31
d5e0c969c58ad04f,mint,549074381,52762641,762836,78488,602678346,2022-10-31
be1447cc36143027,at&t,879132468,28000363,33659,7457,907173947,2022-10-31
adf8d73931a4b207,,13919,2525,0,0,16444,2022-10-31
b1f0aa275d305ae4,,716405077,72921044,0,0,789326121,2022-10-31
b0935d7dfb805697,mint,90869672,1424549,84,84,92294389,2022-10-31
b7d42d62c58f6838,mint,3946442555,85395273,227,85,4031838140,2022-10-31
830ce26904c52da7,t-mobile,181597289,10562778,0,0,192160067,2022-10-31
32a490c9591c8322,mint,1584492880,80495692,250301,75623,1665314496,2022-10-31
316aa44121e93892,t-mobile,522864442,39996825,1796691,240531,564898489,2022-10-31
d573fd06ebb13a96,,166287191,3083055,0,0,169370246,2022-10-31
3528f93662384972,t-mobile,703662030,34369079,22088,3666,738056863,2022-10-31
8e2c9a0310c24b76,,310526088,5049269,0,82,315575439,2022-10-31
bc2fc0f312622252,mint,0,0,1448194,210874,1659068,2022-10-31
a0dcfbe050effd1e,t-mobile,741383582,79914790,124625,43678,821466675,2022-10-31
fcb0e6226700be1d,mint,264652068,12701441,0,0,277353509,2022-10-31
23118b223886da91,mint,108679210,2413538,195406,53576,111341730,2022-10-31
e7c6ec1b1b7d09ea,mint,628179458,51125964,75698,27999,679409119,2022-10-31
e27569f3230d1bdf,mint,2071800838,45464360,6672,1948,2117273818,2022-10-31
4e651268cb9a94ac,t-mobile,495104381,5296621,19564994,789722,520755718,2022-10-31
ad6cd5ffcc5e64e3,mint,665543906,52836506,67793,21046,718469251,2022-10-31
9d437ce452f33cd6,,201128343,3469821,0,0,204598164,2022-10-31
f7f8fd404885e1b4,verizon ,5881821316,150828237,1779985,225407,6034654945,2022-10-31
6fe5295e39abdf20,verizon ,1201601553,46016790,1954049,313790,1249886182,2022-10-31
19f3609eb85c5496,,31788,10129,1586581,379709,2008207,2022-10-31
da8239969ba822ad,t-mobile,28246372,4223345,2458588,906002,35834307,2022-10-31
a8ce1961d83cb2ec,at&t,1240790905,112673511,27426,9531,1353501373,2022-10-31
79225cf32a5697db,verizon ,443912489,23090955,1816886,221804,469042134,2022-10-31
f9372f982d27eeb6,at&t,1200508282,52085233,759039,55402,1253407956,2022-10-31
4498bb4ab9e116ba,at&t,3858872380,85824289,219972,90734,3945007375,2022-10-31
470b2250a2b4326b,verizon ,214589898,3487772,2054455,333277,220465402,2022-10-31
0344b9e2132f401b,verizon ,773573045,12922926,125547728,2047811,914091510,2022-10-31
79b5ca8921326964,mint,834156022,77233557,751311,240247,912381137,2022-10-31
bda9ad978707024f,,621296401,36822788,1073475,183498,659376162,2022-10-31
e7845dc622be5edd,verizon ,386845474,4787975,2440193,313318,394386960,2022-10-31
7e9cdce54e6d7951,t-mobile,203721794,9628733,925232,67761,214343520,2022-10-31
ab9ea70943a99a44,tello,710918802,71866317,8318,2800,782796237,2022-10-31
9cc49e560b437607,at&t,2568735343,83124832,0,0,2651860175,2022-10-31
14006261179c50d8,verizon ,671292324,66314487,68974,19771,737695556,2022-10-31
c163c127e6a54b82,verizon ,0,0,2057739,298982,2356721,2022-10-31
529960799b201b98,verizon ,329841663,22496614,1336217,72213,353746707,2022-10-31
49dd58aa4f8f56b0,at&t,820929625,68157665,6482,1472,889095244,2022-10-31
4de0ed21ff9f80d6,verizon ,330396779,35036834,18771,10897,365463281,2022-10-31
a618dc0d815abc6c,at&t,616894565,74452847,688706,80765,692116883,2022-10-31
d35907cb19263041,t-mobile,1205947967,23837733,1098498,205697,1231089895,2022-10-31
32b84c34900e0657,at&t,189139921,16948274,11887,1885,206101967,2022-10-31
888447d0782c38a8,at&t,173831923,6576622,112,1688,180410345,2022-10-31
4af8aaa8646facb7,mint,1962449940,55241465,104,104,2017691613,2022-10-31
96d18c1712998fdb,mint,561861426,49816514,0,65,611678005,2022-10-31
4b9b9136c5d8195d,mint,4636275201,90131142,70284,35066,4726511693,2022-10-31
2eb684429d0bbdca,t-mobile,544014008,26251462,695839,53455,571014764,2022-10-31
d9aa4d63fabb9374,mint,191384187,17276257,1209865,68944,209939253,2022-10-31
5f2c299b2e663ea1,mint,1156263032,63606372,7397,2783,1219879584,2022-10-31
f41fa827e9c9e784,t-mobile,401564397,41981810,0,30,443546237,2022-10-31
a5e8ba9c40ccdb0c,tello,760655842,61709840,804,10381,822376867,2022-10-31
2fe3b97ad6aae221,mint,470677923,27453437,123492,45526,498300378,2022-10-31
0efbd85c18781a30,mint,1016407164,82795189,199277,79093,1099480723,2022-10-31
d6b92274128516b1,red pocket,5447002699,140387189,85114,37064,5587512066,2022-10-31
f1641f79832a8fc5,mint,764981302,50659044,684341,40663,816365350,2022-10-31
a8615eddee0c720d,,156454287,2175449,0,0,158629736,2022-10-31
a1b6e7be3da6c0ce,mint,881190377,48214678,833933,94876,930333864,2022-10-31
3cce376f73bfff77,mint,3725866047,52807687,2091707,318412,3781083853,2022-10-31
f2eed3457fcdf37c,at&t,671525180,76055899,78677,37242,747696998,2022-10-31
ceab2ebeacf9c3da,,3353717,429485,0,0,3783202,2022-10-31
69440f992f0e5eb7,verizon ,3679082772,68916661,161172,54902,3748215507,2022-10-31
ba439ff96e643b2b,at&t,953824229,70214854,116400,41195,1024196678,2022-10-31
e1db5233f35c1342,verizon ,243169704,25674906,48026,18703,268911339,2022-10-31
f356a8ae8d705154,at&t,936184821,85691492,1147218,122711,1023146242,2022-10-31
18e2fb7de86a07a3,at&t,956680333,63648094,974532,169150,1021472109,2022-10-31
2ea3515568d922d0,verizon ,481645410,49761353,1088476,74969,532570208,2022-10-31
1feff11c6ff4ab1f,mint,494347183,59228740,844471,90953,554511347,2022-10-31
c15c76caaf588e96,verizon ,501975475,51201548,44247,15834,553237104,2022-10-31
9eed826dc6b0e273,mint,639314413,70736556,81385,38157,710170511,2022-10-31
eb21fe7c04413c23,,27847,7667,0,0,35514,2022-10-31
65d919511e207be6,metro by t-mobile,719746881,79561186,139642,46256,799493965,2022-10-31
b6c62571a33ab423,mint,417478401,51160867,14197,4652,468658117,2022-10-31
9ca851ead53dd504,mint,680606961,59787981,33897,10167,740439006,2022-10-31
c9425ec9e5f5c1ca,t-mobile,405844946,28204290,966252,127361,435142849,2022-10-31
588c0103dd88be8f,mint,517362460,66534405,686872,51203,584634940,2022-10-31
580deeb480576ac2,t-mobile,323310583,39338059,95304,28092,362772038,2022-10-31
481dcc55fd663c27,verizon ,3530068565,41600716,731367,56037,3572456685,2022-10-31
97ded7f4d7e56bd7,t-mobile,17629034887,130304202,1851620,411771,17761602480,2022-10-31
fff69f6c93e7ec24,freedompop,446976968,20653888,8517,3853,467643226,2022-10-31
989a52389c2d5688,t-mobile,553451292,61884765,1171900,229917,616737874,2022-10-31
cec6e3aeabddae77,at&t,3561058669,68443024,740114,52594,3630294401,2022-10-31
960f404eba77dc0d,t-mobile,666543736,67768263,0,104,734312103,2022-10-31
402059eff3125634,ting,252108520,11287152,53033,14670,263463375,2022-10-31
66f47c5e028694db,verizon ,417431615,62014851,657250,30034,480133750,2022-10-31
da7ece12fa270eb1,at&t,885494958,92655344,1081694,172575,979404571,2022-10-31
523c70b40eb0944c,verizon ,907320563,383466958,5427,1753,1290794701,2022-10-31
53500f24ed76ba5f,t-mobile,1447643116,68754305,66664,20763,1516484848,2022-10-31
8b0582fecf4b5ae9,,226748602,2387295,0,0,229135897,2022-10-31
700f1962dfe91a6f,verizon ,493178347,51495592,751335,78960,545504234,2022-10-31
4f01dc0b4ab8e1e9,t-mobile,698751112,66079716,275633,30207,765136668,2022-10-31
726e252c85a4ae30,verizon ,1030833309,48754026,901376,125236,1080613947,2022-10-31
577fcdc6d067dd8f,at&t,6191530,1072176,1344144,118323,8726173,2022-10-31
669fb7c52d006931,,70837,40725,0,0,111562,2022-10-31
eeabc66a1588a20e,t-mobile,2904046646,63936810,104,104,2967983664,2022-10-31
36adcc377ad02dd4,mint,1105035856,56695722,1148813,230020,1163110411,2022-10-31
d21039cfa9d2cef3,cc network,545536805,42000758,53574,51838,587642975,2022-10-31
8f005b3c81c1a7dd,mint,577800129,63336073,911832,132399,642180433,2022-10-31
a0d8d00ae3fc1577,,149945407,2765403,0,0,152710810,2022-10-31
f383077b90425779,mint,550383702,49908074,6353,1018,600299147,2022-10-31
503c461d3ed7c446,mint,376642718,38639493,17419,9647,415309277,2022-10-31
66047abdc8bea428,mint,524741389,44383740,1613186,270010,571008325,2022-10-31
43505e94d1913edc,t-mobile,519822483,41466572,301972,7943,561598970,2022-10-31
3a3ba02e673b99cd,,2815259155,77966918,621660,44176,2893891909,2022-10-31
7db319578c3caf6d,,129328142,2565894,0,0,131894036,2022-10-31
07f0e466282232a1,mint,885645979,52965843,170800,45414,938828036,2022-10-31
2bcb0616936f13a7,,2702513,395384,0,0,3097897,2022-10-31
4269d14825660a9a,at&t,782315567,25468876,164730,65998,808015171,2022-10-31
461a2b4e4c57aa82,,55986016,1346881,0,0,57332897,2022-10-31
5143536ab24384aa,mint,175936460,17859938,1359563,123770,195279731,2022-10-31
b06f2722a6775ab7,t-mobile,994157030,25124436,6935,2212,1019290613,2022-10-31
702b87ab4ab310e3,t-mobile,551435177,37999106,909387,110824,590454494,2022-10-31
62f102c22d3b28e2,mint,339293819,10090736,839305,120715,350344575,2022-10-31
2692de0a7ae5df24,mint,392639882,43429794,1353650,119946,437543272,2022-10-31
7333a1e745d14e24,t-mobile,13329938,1262088,324968,127160,15044154,2022-10-31
faf7280c03d69477,mint,0,0,0,0,0,2022-10-31
b9ba31fe11b62d66,,149435549,2745354,0,0,152180903,2022-10-31
328b4b729b23f19a,mint,566086975,21930810,872109,736042,589625936,2022-10-31
e8a4366e2c370141,cricket,0,0,1413503,326329,1739832,2022-10-31
dc0d1896b0c52da1,,206695624,4569470,0,0,211265094,2022-10-31
8462d93bdf1849e5,verizon ,1531766356,47879421,1704809,485298,1581835884,2022-10-31
d11a5c3e7a377641,at&t,2019161931,64470263,1658340,511505,2085802039,2022-10-31
4857a4f019c968e3,verizon ,661532157,47621403,6412,1942,709161914,2022-10-31
a853a63f8c2390e3,mint,14703748253,173455409,0,130,14877203792,2022-10-31
3561e9c156bdc8c9,verizon ,885921396,76967694,0,0,962889090,2022-10-31
a2d66e859e55b67d,xfinity mobile,3743924409,107414405,135182,56843,3851530839,2022-10-31
7f54274c22a13d4b,verizon ,863271035,63208924,772386,72527,927324872,2022-10-31
4b4b64adade5f965,verizon ,602764060,4664512,1291747,79184,608799503,2022-10-31
5788bfa76a0c8ac5,at&t,572701751,21000558,1715770,210129,595628208,2022-10-31
60bca99eafdfadc3,verizon ,731629074,23499436,17095,9106,755154711,2022-10-31
0c89935c8465f4e5,verizon ,1779843818,48612183,0,170,1828456171,2022-10-31
172f098d1fdd00a5,mint,254042893,26874567,1602379,103842,282623681,2022-10-31
33ceded7101898d2,mint,3296011304,27920010,1881804,266564,3326079682,2022-10-31
bbf640c3ce5b8c2c,,176155005,2932051,0,0,179087056,2022-10-31
ac862865acfdd6e5,,101306734,2286786,0,0,103593520,2022-10-31
461b32ba9679e750,mint,265636067,31067068,83,109,296703327,2022-10-31
a3c7fba3a6d4a2f2,metro by t-mobile,2050338266,35603220,1343419,76096,2087361001,2022-10-31
a078152c4eb3ad3a,,926118335,31547089,0,0,957665424,2022-10-31
29603d01d22c1114,verizon ,3382259766,106309780,1030139,134433,3489734118,2022-10-31
7b993940d36261dd,at&t,707330182,71298142,13292,3402,778645018,2022-10-31
faa6f958194e6c23,,469579,377500,0,0,847079,2022-10-31
c343d62606102c4f,cricket,1205452611,72783501,1352411,82370,1279670893,2022-10-31
3780670ae3a79996,at&t,797602566,68552070,979773,159243,867293652,2022-10-31
13ca81b371461e0c,verizon ,950957599,73622646,0,0,1024580245,2022-10-31
fe85196ca419ee04,home,9966143186,245038380,1850293,263497,10213295356,2022-10-31
7dde2a0dd001d6c4,verizon ,445828954,59254127,840922,84189,506008192,2022-10-31
0ad5c0e9df3f5d29,verizon ,1213296701,79075041,714507,48467,1293134716,2022-10-31
d6db0c3413a26213,bell,33168578612,259435046,856828,90640,33428961126,2022-10-31
f26eb637ed9ce380,t-mobile,1439996830,63452549,1249920,70026,1504769325,2022-10-31
f1245c873b290dea,t-mobile,1170176266,19434463,668779,116670,1190396178,2022-10-31
9bda9c86add4eed5,verizon ,2683428060,54130683,173118,58073,2737789934,2022-10-31
c9e4076a8c97f91c,mint,538685481,34765503,1285747,226017,574962748,2022-10-31
35a470a7a82db081,mint,527533216,56805087,6672,1948,584346923,2022-10-31
f6cf2e3f15bc1cbb,,21036,3828,0,0,24864,2022-10-31
b2ac92b0889dc55e,t-mobile,73917710,12321112,0,0,86238822,2022-10-31
20fd0ed4fe024133,mint,906932527,71226130,20785,7008,978186450,2022-10-31
be30facd197762e2,mint,738610684,49162952,158135,59809,787991580,2022-10-31
ba9f60da7663a453,t-mobile,732598923,40761074,6672,2020,773368689,2022-10-31
de9cceb307adc2e2,t-mobile,882702,249778,130922,40931,1304333,2022-10-31
10fc72fd5794d41d,mint,428312957,13324150,0,0,441637107,2022-10-31
631503199d9614a1,mint,1108607211,82912495,31777,17679,1191569162,2022-10-31
920b7b3fdc435d23,t-mobile,297808132,5189001,6962,2283,303006378,2022-10-31
78bb35431ea4344a,mint,379518627,27131161,13535,3981,406667304,2022-10-31
fb0bd9eefc348ed9,home,734110818,17754449,0,0,751865267,2022-10-31
7648cb062210b65e,mint,273915338,9399704,0,0,283315042,2022-10-31
839bef0ca86f1308,mint,687960350,46088583,1033630,191148,735273711,2022-10-31
5d22bb209a7981d9,t-mobile,517536798,29439528,113135,55871,547145332,2022-10-31
9d76b0d124a34bf9,,179828694,4136118,0,0,183964812,2022-10-31
e4483c802179ec92,mint,6658960779,153413157,104,104,6812374144,2022-10-31
d42a450bb1dc95b7,,326984522,7111664,0,0,334096186,2022-10-31
b7daa8476479e4d0,,17968,6308,0,0,24276,2022-10-31
4f1a2c5809091f34,mint,945261458,19589804,259194,94855,965205311,2022-10-31
b1fb05f33d2e397d,mint,1247399279,49096288,266577,103117,1296865261,2022-10-31
137016b416c4d68c,verizon ,440189049,40668998,746801,115172,481720020,2022-10-31
bdc884972f9b5f41,mint,1847758665,81874758,2324668,435058,1932393149,2022-10-31
d958f9319bc0083b,,18238548,902401,0,0,19140949,2022-10-31
24644e279476e6db,,342679794,5742182,0,0,348421976,2022-10-31
903ed1b45612c23e,mint,746155624,81436369,227,165,827592385,2022-10-31
6e0fac07991c3c28,mint,1531639725,61334966,168,168,1592975027,2022-10-31
0aeb4f1a7e03fbf6,verizon ,559728069,62965759,109793,38644,622842265,2022-10-31
d8b788b35d50f16d,at&t,1113486306,73993487,6671,1701,1187488165,2022-10-31
4ff0d2318c9d09fd,,8157012232,116471078,737168,377066,8274597544,2022-10-31
5c78346c12a6cbe2,verizon ,634020328,24438067,1227127,225093,659910615,2022-10-31
662d18c4de61d0eb,verizon ,565146886,37893112,168856,54812,603263666,2022-10-31
9a1fb8943b239247,,230799134,9125905,0,0,239925039,2022-10-31
0c5ecc2f6da988b6,verizon ,2055972178,104667209,102310,48697,2160790394,2022-10-31
b136de49a64d7a2e,mint,3533493491,104983814,11750,1781,3638490836,2022-10-31
b8efe38b144503a7,at&t,1216031716,91193314,6758,1649,1307233437,2022-10-31
9e02465472349160,verizon ,566113922,58312807,812,734,624428275,2022-10-31
41245ce34fe0149e,mint,740835829,74517182,1719612,349341,817421964,2022-10-31
6439912cdd2ca420,mint,279702220,38763821,1116907,274360,319857308,2022-10-31
ef065dc7acac21ad,mint,0,0,34182,8571,42753,2022-10-31
901d58ee9aec8164,home,460612041,28000708,1461990,229475,490304214,2022-10-31
13892624f974bb44,t-mobile,812192887,25452169,1281650,306650,839233356,2022-10-31
c0c735e7469fdf3e,mint,21527752818,162751399,609195,60867,21691174279,2022-10-31
2b74f00f21dd36ce,at&t,751469244,60604940,1681585,177723,813933492,2022-10-31
1ff2ce00cdb2cf4e,mint,570566542,50958371,694408,59521,622278842,2022-10-31
a5d3edd16e6d4cb5,at&t,54798578,5412706,9044,2726,60223054,2022-10-31
7c38af549bcd715f,mint,602731369,40375069,725614,45507,643877559,2022-10-31
e6f2a40c43bccdb4,mint,1273981302,59200140,681126,43081,1333905649,2022-10-31
d7b4a065b5eb2721,mint,689952651,74317378,21669,6194,764297892,2022-10-31
fd6d695d11355178,,83352256,2287699,0,0,85639955,2022-10-31
e5e6457324ba13a5,mint,160665909,13769109,705609,101195,175241822,2022-10-31
983040c3c67cb0c7,mint,975351697,53365775,26548,18281,1028762301,2022-10-31
57273a934cb3a301,cricket,256174708,11046749,1829,21715,267245001,2022-10-31
fe206c0bcac3ef0e,mint,638697445,34900004,1136436,207255,674941140,2022-10-31
db51ee2267a2aee1,at&t,1362847824,56576583,6974,2089,1419433470,2022-10-31
6b007b00b5eaf0df,mint,1032075173,48312344,1799,2088,1080391404,2022-10-31
99ed3fe46154651c,t-mobile,690663888,76737735,7007,2297,767410927,2022-10-31
70e482b6601dd95b,mint,251769557,32291028,757424,64906,284882915,2022-10-31
cf116dc13d8df067,t-mobile,744924481,49059247,719692,57408,794760828,2022-10-31
e7a6c522c8e16b01,tello,380928763,32220864,654070,34439,413838136,2022-10-31
e2af25cefeb06c27,mint,492741533,40613618,104,104,533355359,2022-10-31
69cd46431817387b,,535329514,44131918,111579,42998,579616009,2022-10-31
95901597c363f47c,t-mobile,416845771,39709696,6863,1889,456564219,2022-10-31
10b295d903e2d961,mint,4348678842,97104702,7019,2535,4445793098,2022-10-31
ed808af9a614825a,mint,672581985,51929086,1130773,170269,725812113,2022-10-31
64280d6d8d668630,t-mobile,1098175702,78570651,1048013,188098,1177982464,2022-10-31
0d8744cd9704c41b,at&t,882598240,46270300,838416,80323,929787279,2022-10-31
41fda8984f4e6046,,230995643,2382219,0,0,233377862,2022-10-31
665498150fd73fa2,t-mobile,170406776,26199316,1284147,77840,197968079,2022-10-31
aab5110b0ae8891b,verizon ,494354945,40116167,2366600,419059,537256771,2022-10-31
bb94aa1dc52e5ac6,verizon ,608285217,47475977,1984670,288839,658034703,2022-10-31
a602d88896988cca,verizon ,2961558818,75844751,1095502,181366,3038680437,2022-10-31
9e29224c43db6884,mint,834943063,65816566,1333434,82879,902175942,2022-10-31
721e866a8f5e7dac,verizon ,551454071,59363598,1008366,147462,611973497,2022-10-31
c170a08200bc3dcd,inland,371572333,30787443,154324,71683,402585783,2022-10-31
8be0f927c1545b13,at&t,8319888561,105746367,14258,4318,8425653504,2022-10-31
78e36ff9efe5b7e8,verizon ,905398118,63380583,1618448,365202,970762351,2022-10-31
109bbb118bddad87,verizon ,656951486,62710741,0,170,719662397,2022-10-31
6216380bdca68e71,verizon ,804132274,54737713,6661,1793,858878441,2022-10-31
efadf0a9a46d7f2f,verizon ,973562715,72809551,961077,153100,1047486443,2022-10-31
c3cde340a0ae6ada,at&t,395926149,17596329,205,26487,413549170,2022-10-31
7ce00f27d0359a8b,verizon ,925471649,48844193,8566,2349,974326757,2022-10-31
b333a950d93fe276,at&t,2686636,397271,1150904,268426,4503237,2022-10-31
8e3a06faee690756,at&t,73522059,1463476,58872015,1163684,135021234,2022-11-30
40143e24f021e5d7,t-mobile,572260432,27691917,2146927,353850,602453126,2022-11-30
5ee0e87b3bc3737b,,1174113416,61526375,37382,23392,1235700565,2022-11-30
b1aa742a8565ed25,mint,231579147,24245183,1688,2139,255828157,2022-11-30
902e4e6623b9324f,,139483728,2250399,0,0,141734127,2022-11-30
dc3d47c2a365aae5,mint,915448346,86117915,0,85,1001566346,2022-11-30
9146ac5f16447a5f,,727698,247237,648589,181304,1804828,2022-11-30
ec00659571dd1ae2,,745948,220330,0,0,966278,2022-11-30
e78e0499ce28d863,mint,53597067,1574533,0,0,55171600,2022-11-30
9678a228c020e954,t-mobile,1130783847,69549090,126729,48599,1200508265,2022-11-30
c0fbf447d9332b89,mint,748738502,37304349,6672,2020,786051543,2022-11-30
6d6eab86d6bcc2a6,mint,20834,7311,13868,2435,44448,2022-11-30
93d8b1fa47677016,roam,0,0,1138648,559985,1698633,2022-11-30
5867199866b8e8c7,mint,545862441,8819895,0,0,554682336,2022-11-30
9d6e3f8c61d5b265,mint,1013823616,73964240,704487,49474,1088541817,2022-11-30
6942874b26f6ec2d,mint,651414224,57211444,0,0,708625668,2022-11-30
66590500c1493d72,mint,287010944,24676312,7911,1763,311696930,2022-11-30
f5e0e4ab2f217dc5,mint,1268151821,74534761,165185,57444,1342909211,2022-11-30
811a2a021dc284e5,,294589245,5309003,0,0,299898248,2022-11-30
255781410221d86b,mint,979690892,74118443,48313,11214,1053868862,2022-11-30
38f76b84f9422e10,,710530232,60571100,920116,159377,772180825,2022-11-30
112d74191a366419,at&t,1027423967,72873449,1056,7216,1100305688,2022-11-30
86249a129048b650,mint,1003666030,9644582,28546,9878,1013349036,2022-11-30
a16714c4c410f684,home,75481538,1061395,444828,135878,77123639,2022-11-30
fefe86b72d763c72,t-mobile,1108301804,71640345,55104,19256,1180016509,2022-11-30
fa511724fb7fafce,tello,1877081067,65829186,21677418,912766,1965500437,2022-11-30
579a98b9147beb27,t-mobile,902828,284355,99736,34609,1321528,2022-11-30
29fae2e3f7a7d6a8,mint,586489522,47875829,1554032,172580,636091963,2022-11-30
e19fbc8e8303d1ca,mint,998763282,71512687,1734613,196968,1072207550,2022-11-30
045c48667471a395,,36658026,5629925,0,0,42287951,2022-11-30
c8bbc466f2f6881b,mint,610076919,59236935,57937,20067,669391858,2022-11-30
f7e110cc65e6bf55,,70559355,1055033,0,0,71614388,2022-11-30
0e13daedb601b549,wireless,767600755,78635680,19426,5655,846261516,2022-11-30
536e426c8bb38a53,,560921636,53653919,12128,2878,614590561,2022-11-30
a9b85e7d895715b0,,2254015640,35334320,0,0,2289349960,2022-11-30
cc131de68fd4e9f7,verizon ,418941871,7100525,860369,233686,427136451,2022-11-30
f8a0129120bdd6af,,32061,7411,0,0,39472,2022-11-30
db09b9dffa724ac3,verizon ,671173306,69777545,39345,24235,741014431,2022-11-30
ee9e9cfe3bc2aea4,verizon wireless,1138323845,83189787,70810,21868,1221606310,2022-11-30
1da6b28114477726,verizon ,1089580415,86449577,840712,83555,1176954259,2022-11-30
0d85257cd1e694cf,verizon ,1088797,505910,84,84,1594875,2022-11-30
a0ace2ee2a629d1f,mint,626269996,35256264,692882,22466,662241608,2022-11-30
cd8c1b5529b24319,mint,844677704,67751302,1313130,257293,913999429,2022-11-30
3772f0e7f8eeed9a,mint,694618,193350,246919,68385,1203272,2022-11-30
4bc68f964779c0b6,mint,314756,323761,589900,182977,1411394,2022-11-30
f0cc30fdc9c3bac0,,917541559,51737662,874827,151398,970305446,2022-11-30
c31a244a4d1d7fb6,,2875694767,109884506,2524623,438098,2988541994,2022-11-30
3083afc1d82abbe4,,50974053,4446545,6853,2271,55429722,2022-11-30
89ab0a15a366e23a,mint,432379043,46463996,41903,14106,478899048,2022-11-30
9171d7d82b2d4224,mint,339751796,36728094,104,104,376480098,2022-11-30
7cc59e305dddf8ca,mint,852164,239630,198159,65853,1355806,2022-11-30
455ccbdab46e5726,t-mobile,731577,772691,141468,44956,1690692,2022-11-30
29f6b4642393bfa3,ting,733428853,36963628,0,0,770392481,2022-11-30
dc40ccba4dde7252,ting,1027537601,79038933,171,65,1106576770,2022-11-30
2db0b6cf6611f82c,ting,274714244,12503295,1719,14554,287233812,2022-11-30
9691d6e73347cbaf,t-mobile,277110,70627,0,0,347737,2022-11-30
849b30141fe5e997,,146649814,8404558,0,0,155054372,2022-11-30
99bce9de8bc2c7d7,t-mobile,302229155,7046661,0,0,309275816,2022-11-30
34906bb98bb218fc,,150047006,3170218,0,0,153217224,2022-11-30
3f0ba899e04d7862,,82191045,1144905,0,0,83335950,2022-11-30
8e91114d6d7047b8,at&t,618924192,56032160,882782,96784,675935918,2022-11-30
d85956020deb8c91,at&t,864386982,93393803,1516,26853,957809154,2022-11-30
eeae763068786dfd,verizon ,1089811094,40951710,30461,6723,1130799988,2022-11-30
642b1cdc4e051475,verizon ,564072484,24839591,24743,7152,588943970,2022-11-30
34e80f736840fcc2,verizon ,405289,314215,288048,262178,1269730,2022-11-30
9fd3786ee0255891,cricket,963720580,51950443,20428609,444179,1036543811,2022-11-30
cd81472b88052dda,at&t,989466458,65005239,1042629,170515,1055684841,2022-11-30
876743be7f13ee88,at&t,575529991,47678310,1954926,303769,625466996,2022-11-30
9c3b8ed007a2b97c,mint,627630230,45228665,1229799,226159,674314853,2022-11-30
647bbc14bb232a82,verizon ,0,0,1004174,346875,1351049,2022-11-30
7eb3b1c8f2c81790,at&t,837380346,59736236,1390401,69978,898576961,2022-11-30
060a2ed5b7fbbf13,at&t,0,0,1431281,316253,1747534,2022-11-30
5e24a8c3c87ebbcb,at&t,0,0,1418424,140012,1558436,2022-11-30
8c415eed52065f7f,at&t,1174500934,73316232,40921,12239,1247870326,2022-11-30
2505c31a14064bec,t-mobile,20775327356,159626675,50002,244807,20935248840,2022-11-30
fec05724aa764e76,verizon ,841679617,73551763,1818024,194520,917243924,2022-11-30
58ee53df0e48b94f,verizon ,716075066,14116291,268500,89620,730549477,2022-11-30
7549fc3acaf67251,verizon ,947953825,91886724,0,0,1039840549,2022-11-30
83e70beb99552a17,t-mobile,338837644,30603408,15289588,367838,385098478,2022-11-30
f2d053e91a3afcd8,at&t,666162689,70024267,1945890,297829,738430675,2022-11-30
0ea88250cc31da76,verizon wireless,0,0,2073563,290959,2364522,2022-11-30
cf1c80ce6729c52b,,652189288,50549663,828553,124831,703692335,2022-11-30
fa38b3843ebd3803,verizon ,789782920,54044830,302831,111467,844242048,2022-11-30
60930abc74a8a2bd,verizon ,878254110,81607937,1574869,320103,961757019,2022-11-30
450194666b271919,verizon ,95668363,3896843,4417,103705,99673328,2022-11-30
c0132c72cd97fbf8,t-mobile,1195018082,85336174,475268,151192,1280980716,2022-11-30
d0a1acb7c43039df,pure talk,0,0,26032,26090,52122,2022-11-30
196a41b759f3dd2b,xfinity mobile,12203347,1682187,49560,15818,13950912,2022-11-30
cfb636b9d94562d3,verizon ,12413310,1127925,0,0,13541235,2022-11-30
a030a1a5891e48e7,mint,870255,229889,43133,11547,1154824,2022-11-30
78fc34f34e365a80,at&t,788405,258730,462366,121982,1631483,2022-11-30
4cc7627cf2052b2a,t-mobile,98689,28609,913427,273465,1314190,2022-11-30
3bee639d9814af7b,mint,594878964,46365537,0,0,641244501,2022-11-30
9d1ca21d29cd7c26,at&t,573809,2182945,0,0,2756754,2022-11-30
fca75be44766d4dc,at&t,1705243399,19106318,1586944,213621,1726150282,2022-11-30
9c1a0ee588821b55,mint,880103,242758,16502,7807,1147170,2022-11-30
2b935cc4ed807595,mint,39005472,1380070,0,0,40385542,2022-11-30
475e9940fcc41f7a,mint,3339264512,91954017,682719,27128,3431928376,2022-11-30
4755de5dd56bec9a,mint,308613409,23820007,243576,93224,332770216,2022-11-30
e9db0b4102835cf7,mint,275436209,12286784,788597,119072,288630662,2022-11-30
13c06c1a4182de6b,mint,848521443,83961476,127902,38664,932649485,2022-10-31
ace1208d3f4ecc9e,t-mobile,652472688,68820122,1865174,299499,723457483,2022-10-31
30709107b40095a3,mint,244333520,17797817,498,3339,262135174,2022-10-31
a049f9abfbff7b64,t-mobile,622129686,30794097,6756,1817,652932356,2022-10-31
dcc4077df6446578,mint,1403506851,59310879,21642,5297,1462844669,2022-10-31
6e8306ed8cc2e3f5,mint,1015091913,55988320,0,170,1071080403,2022-10-31
d87f6bfb3381e653,mint,2075171943,69679648,6935,2212,2144860738,2022-10-31
cef0404a65efc492,mint,320884395,36206967,173037,64635,357329034,2022-10-31
3689ac676ac2b87d,mint,559438224,29101612,54415,30164,588624415,2022-10-31
2fad9fc73f974eb0,mint,559563561,57842402,199,249,617406411,2022-10-31
bc3d38ab4f601807,mint,657972159,46453219,57354,23198,704505930,2022-10-31
f863fc29c2ba645e,mint,1582236292,77407911,6967,1993,1659653163,2022-10-31
1b30eede9e87a70e,mint,735201684,31630953,70682,25671,766928990,2022-10-31
efde317df0e47194,mint,806058930,63267813,6057,2104,869334904,2022-10-31
9dc4f237ef50a2f7,mint,462884721,33416159,1349000,95662,497745542,2022-10-31
e5650c7bab66df8b,,48169745,5270774,0,0,53440519,2022-10-31
fb43a02b9d64cc69,mint,487842463,47923478,691574,57654,536515169,2022-10-31
8706c0ef982224a0,t-mobile,509092507,33978848,1262970,275356,544609681,2022-10-31
6ae8bc0ae1cad496,,572880532,21989690,84,84,594870390,2022-10-31
686080c5c6bfc7b1,mint,2975621785,97997174,0,0,3073618959,2022-10-31
afaf17aa94ba36aa,mint,386115587,39272551,106576,31804,425526518,2022-10-31
b2c0f825b3a6685c,mint,1203604933,75543846,338476,111449,1279598704,2022-10-31
b88ac9930d40f335,mint,1700337563,93157716,802511,138747,1794436537,2022-10-31
7411d855240c20f2,at&t,436825790,50531518,6619,1472,487365399,2022-10-31
5bc9ede3af039827,t-mobile,579676874,38887592,46350,21872,618632688,2022-10-31
0e5215ddd201ae19,at&t,699027841,56267039,151904,48112,755494896,2022-10-31
71f5e7d0019cd257,verizon ,510551131,60940823,8342,3924,571504220,2022-10-31
160d8a9f024b4055,verizon ,964556012,35400983,1759121,245040,1001961156,2022-10-31
559f4400342724dd,visible,910571630,60976610,0,1650,971549890,2022-10-31
3985efb7250f2821,koodo,517492376,42044055,1356184,177057,561069672,2022-10-31
64467de9bad3eb4e,at&t,224940818,25344308,322944,13594,250621664,2022-10-31
b4cf755d3585375a,mint,682791957,51199118,0,0,733991075,2022-10-31
b959bc3a84ad8233,t-mobile,880647158,80593809,6557,1795,961249319,2022-10-31
ebfe6874473a9334,metro by t-mobile,1029409131,54924801,1155444,211403,1085700779,2022-10-31
f2a0eee7ab216215,t-mobile,745142491,52756040,20589,5393,797924513,2022-10-31
c24c0e6c600b1551,,196080313,4910086,0,0,200990399,2022-10-31
ad24b4ad07c517b7,o2 - uk,1554802197,64565975,645377,27634,1620041183,2022-10-31
030e8218bd93f04a,at&t,395449352,42958384,45957,279335,438733028,2022-10-31
c59626eb71740a9d,mint,922402826,60127064,109489,33547,982672926,2022-10-31
1eadd092f72c37d4,verizon ,595773843,67308503,15908,9713,663107967,2022-10-31
66cfb069ab4e7b84,t-mobile,628001084,58906112,68376,29818,687005390,2022-10-31
0e0e67a552a29bb6,at&t,3294596553,71381399,729392,61069,3366768413,2022-10-31
0bc937f15ff065c7,mint,525040469,45644188,512444,113713,571310814,2022-10-31
a8df61dfbda44eca,verizon ,760686204,60530526,889953,109218,822215901,2022-10-31
1980aaed490e75d2,at&t,591070345,58455385,664545,29472,650219747,2022-10-31
150171eccf77a2ce,at&t,776915627,85291743,275162,23424,862505956,2022-10-31
50947f4cd0d863cc,verizon ,679342914,54002479,440180,101255,733886828,2022-10-31
3739013b25d3161c,at&t,2067145314,47923064,2021665,343127,2117433170,2022-10-31
4108a24e12c58b26,verizon ,499030689,52097285,1728058,215090,553071122,2022-10-31
57c3824a6288aed9,verizon ,852057781,60446737,20622,5813,912530953,2022-10-31
d1d7da013f109f0a,t-mobile,856387979,62937593,227353,85233,919638158,2022-10-31
a64837fb2981f495,verizon ,1511831428,107894200,711601,51094,1620488323,2022-10-31
7b3a8498aad95897,verizon ,385126667,60779784,84,84,445906619,2022-10-31
6bf9ead997044e8e,mint,794801268,61451768,20197,12478,856285711,2022-10-31
15bc009ec73216af,at&t,614480945,45355679,6661,1951,659845236,2022-10-31
c7f0e86151531aa6,at&t,428434746,46144629,827864,83643,475490882,2022-10-31
8637eadc4922a20a,pure talk,623998951,57413462,6605,1740,681420758,2022-10-31
01166a21bbb85e46,,186155668,2602767,0,0,188758435,2022-10-31
ec77bf2aad17ef81,,149219156,3064491,0,0,152283647,2022-10-31
683dd49147200a84,tello,1141214582,50021248,25983,14520,1191276333,2022-10-31
b942c96aaf29ac4c,mint,998973410,62397229,324280,11293,1061706212,2022-10-31
12d1cc79e156bc6d,mint,1239838026,53382202,47312,25047,1293292587,2022-10-31
2527716bdbd41ab1,t-mobile,557365630,45727723,20797601,921162,624812116,2022-10-31
7e7cf569c981fa39,mint,659858391,73176779,103861,41546,733180577,2022-10-31
8e57afdbddfaafa4,verizon ,4733234962,154825039,240865,81346,4888382212,2022-10-31
9f01a1cbc4a19613,,105551821,2096320,0,0,107648141,2022-10-31
4dcbced5996e6464,mint,15788071417,215282379,108203,12457,16003474456,2022-10-31
892818ee5a0c73bb,t-mobile,2386904260,57486359,52359,27517,2444470495,2022-10-31
fdd132fdf34b3706,mint,955947377,46556902,0,170,1002504449,2022-10-31
451b975a4c8c966e,at&t,1696449359,28855605,692978,46599,1726044541,2022-10-31
621f46a3c6bb4443,home,3026038768,70040069,7042,2224,3096088103,2022-10-31
8a26fdbe6b6753d9,,150311730,2762195,0,0,153073925,2022-10-31
8504ea1a547c0479,mint,3086369140,67578441,722854,69381,3154739816,2022-10-31
4b0df71eaffc1d8b,,141460237,3315158,0,0,144775395,2022-10-31
be09e0333fbdc9c4,mint,1781677753,45196645,63337,526564,1827464299,2022-10-31
4cd6b3898adb1102,at&t,1893565129,48855002,1336602,71338,1943828071,2022-10-31
c3653c677a5e2fbb,mint,1651654143,61347069,842761,93722,1713937695,2022-10-31
3086aba1c05f940a,at&t,512028292,40425769,5166,1406,552460633,2022-10-31
b0cf0b31f252afaf,mint,1196596618,60226602,3179691,509482,1260512393,2022-10-31
aa1811c570a798e3,verizon ,813841553,69376127,2058746,325146,885601572,2022-10-31
a5efcf2937da51bb,xfinity mobile,1141900131,59251054,13332,3941,1201168458,2022-10-31
09afee8cfe1475ba,verizon ,191281470,25666145,1764319,331778,219043712,2022-10-31
41166be283c610b3,verizon ,618466017,67910303,231550,72769,686680639,2022-10-31
45452e04f6e48a8c,mint,984920259,53076453,1171230,199021,1039366963,2022-10-31
156fe9a93f07f39c,t-mobile,1125204791,58191501,1995659,254363,1185646314,2022-10-31
59ae6d427bfcded9,at&t,14575318521,301741442,2173126,347370,14879580459,2022-10-31
5fa917de5326314c,verizon ,1832249745,114642480,96586,38234,1947027045,2022-10-31
0c3af9e97bf7f1ca,verizon ,224886454,25356370,598537,81479,250922840,2022-10-31
56640d68a4f86dbf,,166860993,2160722,0,0,169021715,2022-10-31
ec31434778be972c,,756521407,48859136,865046,99334,806344923,2022-10-31
ffecb2c0f9b37693,t-mobile,1381603934,38732412,1186929,83644,1421606919,2022-10-31
c291185061537ffe,,64311971,1372638,0,0,65684609,2022-10-31
923772a73fe40a51,mint,673898865,21558378,0,0,695457243,2022-10-31
8465e26adaa99fdd,,68352152,1611671,0,0,69963823,2022-10-31
f8cc8b44c1ddaba1,mint,623307115,22820175,0,0,646127290,2022-10-31
b7ae1b930d261b34,mint,1287684858,30649320,14669,5272,1318354119,2022-10-31
ddc986edc1cdbbbe,t-mobile,1164955764,30771943,1816284,234457,1197778448,2022-10-31
acd650710b28242b,,79369852,1992426,0,0,81362278,2022-10-31
05fce8b2c78412fd,,176487367,3497198,0,0,179984565,2022-10-31
407d5ef637a8a7f6,mint,439442774,72361410,1517273,309870,513631327,2022-10-31
e06910e3b8d43f9b,,146182060,2171203,0,0,148353263,2022-11-30
ec6d594bc44e729a,,149095093,2919829,0,0,152014922,2022-11-30
71e80763a4198697,verizon ,1414644548,89644946,13661,4185,1504307340,2022-10-31
bbac24045b1210d4,verizon ,564748302,45696368,693399,45046,611183115,2022-10-31
f2c404453dbaa0bf,,11649553,2099293,0,0,13748846,2022-10-31
6d8898d5c89be2bf,mint,978098684,40177060,0,0,1018275744,2022-10-31
a90615e57b2d4851,,118827060,8865667,0,0,127692727,2022-10-31
259bd51e15c1a156,mint,465923295,23815443,104,104,489738946,2022-10-31
27fb0a0ebf00edf8,t-mobile,615884816,32941345,676194,55424,649557779,2022-10-31
1ce7f184d66203d7,t-mobile,1944630078,44696795,1050741,184009,1990561623,2022-10-31
401ef8e5eb9b9b83,at&t,152485442,8856632,43070,128348,161513492,2022-10-31
f1e90d284fccd0d1,,175440880,2682743,0,0,178123623,2022-10-31
53ef77b3191611c2,t-mobile,100928603,7274986,1346264,114900,109664753,2022-10-31
d38f79ed2d331f24,at&t,504547195,50030137,10696,7724,554595752,2022-10-31
4926e9043a240cdc,mint,21872200,3062720,102570,35628,25073118,2022-10-31
e39e7654daf05f2d,mint,636802978,40863402,620578,23041,678309999,2022-10-31
982975709f6c3ab2,at&t,231892319,27903902,729,174,259797124,2022-10-31
89d3b3da404e1923,t-mobile,3616448909,84233408,728431,192168,3701602916,2022-10-31
446bd5914fe1e5a5,mint,590647713,28236344,653674,30498,619568229,2022-10-31
72ea2fef7f44c814,t-mobile,608730392,47217092,1072935,209576,657229995,2022-10-31
bb4a3fc5ce0d711d,mint,576644820,57541871,668424,34399,634889514,2022-10-31
687ea176b9fcc961,t-mobile,0,0,0,0,0,2022-10-31
fa7e4a1033aadf44,mint,595907003,54677206,5842,1381,650591432,2022-10-31
4583d0feb9d549f8,verizon ,3359803555,91538171,1680060,251499,3453273285,2022-10-31
4fd9d5e7796054a6,mint,1164356766,88871031,4139,1758,1253233694,2022-10-31
700c5170de5e471f,xfinity mobile,8990315311,142964629,924193,114279,9134318412,2022-10-31
f498a3a56a2581b6,verizon ,250511965,37135745,1100188,183587,288931485,2022-10-31
7f7fd9f395da8c45,verizon ,626553503,63619481,84,84,690173152,2022-10-31
a613e1901f25744d,mint,959094884,65553969,20343695,128857,1045121405,2022-10-31
22ad6ef7a773e5f7,at&t,617145243,50436706,6810,1753,667590512,2022-10-31
6148ad15a6b02ee6,t-mobile,13436883117,136464415,44614,20857,13573413003,2022-10-31
ccdcd457203bfe1f,cricket,468182573,10420698,30223,39228,478672722,2022-10-31
473bd7313d2acab3,mint,800302501,69574408,349130,121414,870347453,2022-10-31
edd91f57773748a5,verizon ,0,0,39582,7437,47019,2022-10-31
790551de67d16125,at&t,102558252,11466341,103062,6982,114134637,2022-10-31
a43d3d9932e786b0,t-mobile,879517147,32114780,392234,36571,912060732,2022-10-31
8ba2105328375723,,203036892,4205559,0,0,207242451,2022-10-31
35f351890d429cb1,mint,812876478,59152832,0,0,872029310,2022-10-31
23cf8d62a2a860e0,t-mobile,0,0,38043,13449,51492,2022-10-31
a68cb499086c1961,mint,0,0,2261848,358748,2620596,2022-10-31
9d0384cb5abc0fcd,t-mobile,2587573871,42104929,869778,117127,2630665705,2022-10-31
459f445949bc95c1,verizon ,514286450,81192048,168550,60446,595707494,2022-10-31
703f07e4381abbc8,,364298053,6274281,0,0,370572334,2022-10-31
f81745cdbd0294e9,t-mobile,0,0,2112860,328670,2441530,2022-10-31
b91c967889571936,,213263430,2785760,0,0,216049190,2022-10-31
1660defc178edb46,verizon ,457769676,51749554,1255981,248529,511023740,2022-10-31
704aaf150b6f1188,at&t,512191245,54530585,11976,2001,566735807,2022-10-31
e7dc4f1389a57a39,at&t,0,0,2199053,362072,2561125,2022-10-31
529471b6954dd6ac,at&t,702365335,74422745,28146,9419,776825645,2022-10-31
5e48619552946773,verizon ,715351383,55286864,16528,5394,770660169,2022-10-31
a4e3016b4cc8aedb,mint,602438384,42426352,1888829,310825,647064390,2022-10-31
87fb3cf1eb65dc79,verizon ,775359358,74953960,89538,31871,850434727,2022-10-31
3ccdee42eadbaa7c,spectrum,0,0,456149,156757,612906,2022-10-31
196bda116b995dce,verizon ,518874623,54715846,741561,56947,574388977,2022-10-31
88cbc5270a201d5c,mint,767710751,26435156,206507,66389,794418803,2022-10-31
f02aa3559db9fa3e,mint,511822704,54330316,1806851,205430,568165301,2022-10-31
1d264bda0965fbe2,verizon ,367290866,53511934,194264,63450,421060514,2022-10-31
fe360d0797626042,t-mobile,3623719788,77039929,15735,10798,3700786250,2022-10-31
7df66b682baeefdd,t-mobile,1886801736,81230986,684568,39377,1968756667,2022-10-31
0a60b33c29828db9,,151679989,2972483,0,0,154652472,2022-10-31
3349d45186e58bab,mint,485944552,20201989,767411,215985,507129937,2022-10-31
939b92b09a8db864,mint,14357837488,258892087,7305,2644,14616739524,2022-10-31
3360727622c3be8d,ting,333896415,8515092,84,84,342411675,2022-10-31
46618aa7859ae9e8,t-mobile,747411162,52825978,0,170,800237310,2022-10-31
7cb9eeefe7cbba21,t-mobile,519112213,30579615,717901,71829,550481558,2022-10-31
e2151ffe0bd59294,mint,4405844770,117863926,109736,44226,4523862658,2022-10-31
12214e01979452f3,t-mobile,729056931,80788838,734982,54702,810635453,2022-10-31
d8faac1b065b2369,t-mobile,480149801,50295940,14841,4600,530465182,2022-10-31
402c338fa350c5c1,mint,644914949,67262121,436682,57785,712671537,2022-10-31
2bc91e91bfb2ed4e,at&t,1256136092,48714304,352697,26805,1305229898,2022-10-31
573222450d396dc6,at&t,467229720,32126639,6520,1899,499364778,2022-10-31
6a18976b8a78fe89,mint,1271140921,43703082,35604529,602413,1351050945,2022-10-31
44b3deb23a7db5eb,,163969076,3866191,0,0,167835267,2022-10-31
94f5b151b9468655,,127187325,2532501,0,0,129719826,2022-10-31
2d53244245dab7eb,,149423811,2466667,0,0,151890478,2022-10-31
48dcac251705e7c4,t-mobile,23088311745,339819003,19640,11368,23428161756,2022-10-31
63109e5109743629,t-mobile,614686482,19641181,813191,92910,635233764,2022-10-31
c095a97e5f3db6b9,t-mobile,475130925,38454226,1366300,99585,515051036,2022-10-31
4e2fe1d9e09525a8,mint,1811413363,68295728,74313,13924,1879797328,2022-10-31
f4b5359c3a7c586e,mint,12525776228,133755847,27903,8955,12659568933,2022-10-31
0f577379ea4c840d,verizon ,828253222,66238086,855973,99365,895446646,2022-10-31
d4c9cde64b214ed3,verizon ,1061014686,72171908,1726629,402171,1135315394,2022-10-31
84613538e9dc9737,,181565344,1821900,0,0,183387244,2022-10-31
bac4c55b8954ea41,verizon ,534994094,58160072,1302232,66615,594523013,2022-10-31
733cc3f518b29b76,verizon ,1092316133,68613537,636333,40316,1161606319,2022-10-31
ca7f6597f30078b6,verizon ,649679525,67498544,49839,23419,717251327,2022-10-31
8fd87ca66895909e,verizon ,514043171,66517328,710253,48497,581319249,2022-10-31
c3223d355e099614,xfinity mobile,1256791641,73511356,84,84,1330303165,2022-10-31
1076feed6382d1dd,mint,682313338,77454978,707557,49197,760525070,2022-10-31
91c3fd6be929f1a7,mint,2247231014,102110062,1484458,222884,2351048418,2022-10-31
55d6e556ba8ef69e,verizon ,832498212,58747870,25618,11249,891282949,2022-10-31
657a726fdcd07ba6,ting,507138002,49306732,760454,68175,557273363,2022-10-31
38e8b2996ff3152f,,229602721,2474907,0,0,232077628,2022-10-31
4123d0813eaf6130,verizon ,54042629,804158,2019785,287908,57154480,2022-10-31
15efaa637d17f8d9,verizon ,643218003,53840779,1871333,448820,699378935,2022-10-31
5e4c2cef25239381,mint,1879462581,49496030,87483,30554,1929076648,2022-10-31
416f9fc407e81551,,156469966,3431571,0,0,159901537,2022-10-31
6e0066fe297dc75c,,177024507,3467530,0,0,180492037,2022-10-31
965f3c047b01d87a,mint,1090205199,67851856,0,139,1158057194,2022-10-31
1d2d0eb756cf4db4,mint,3635758998,77603019,28691,9575,3713400283,2022-10-31
4aa686e453030e92,mint,2108416017,95704770,7044,2356,2204130187,2022-10-31
77d12d462aafde84,,64029210,4759696,128194,32705,68949805,2022-10-31
786e593773f26b51,,50659129,1254726,0,0,51913855,2022-10-31
5dae9be7d0aae7a0,,76090017,1651240,0,0,77741257,2022-10-31
bec291c197151c87,at&t,1351063776,48376040,905098,104291,1400449205,2022-10-31
84ae6ecc5b8336ba,t-mobile,467417902,47559857,29777,392354,515399890,2022-10-31
e5d19e8a33def651,t-mobile,567328283,58089676,11809,1832,625431600,2022-10-31
74d56c11347185d7,at&t,6408703302,69420599,1353181,150196,6479627278,2022-10-31
938b27996d2a770f,verizon ,948286733,37816295,476,851,986104355,2022-10-31
509f37f7c69ea014,mint,5445810434,113687931,300595,94211,5559893171,2022-10-31
59f096daa41f9b2c,verizon ,198574702,3548866,2038941,292339,204454848,2022-10-31
5837e1fa8e78f925,verizon ,4528999815,70405167,1375716,118033,4600898731,2022-10-31
3ca5d35b074ca4e3,ultra,5544031166,161697660,2080,21698,5705752604,2022-10-31
2fb8e4dd4d6c5767,verizon ,790588215,34942684,682088,43989,826256976,2022-10-31
22c423a196be3579,mint,1125217844,49868507,51918,17718,1175155987,2022-10-31
1577c097245df0d4,,154429282,2168764,0,0,156598046,2022-10-31
2f87e474b3542d63,,154448584,1807616,0,0,156256200,2022-10-31
a4a38dab5145ecfb,,155070438,2384868,0,0,157455306,2022-10-31
a0acf005242de11e,,154749413,1551420,0,0,156300833,2022-10-31
4262c35271e8d18f,,142447024,1694206,0,0,144141230,2022-10-31
653482345d47d1d4,,155536687,3334117,0,0,158870804,2022-10-31
6422bdb8f13dd4a1,,154419072,1899187,0,0,156318259,2022-10-31
1922e5a452980cf8,,155393815,2202189,0,0,157596004,2022-10-31
cb8610542c064651,,154380964,2072682,0,0,156453646,2022-10-31
77a3296fbfa5ded2,,137311087,3667640,0,0,140978727,2022-10-31
3b61aaad8e471f9a,,831448156,7179564,0,0,838627720,2022-10-31
a95ecb139845e5d5,,113371507,3938053,0,0,117309560,2022-10-31
c459dd0e4fbfca70,truconnect,5616798384,86571126,956500,128735,5704454745,2022-10-31
15cc4ff09d21d27d,mint,933997397,35293506,25349,13358,969329610,2022-10-31
5ccee59e517f9fd7,,243592905,4335262,0,0,247928167,2022-10-31
afd2c7b408a8c4ff,t-mobile,4837174108,91873998,1346741,86413,4930481260,2022-10-31
adde95d4ba711215,verizon ,1009228397,37498363,2007025,312158,1049045943,2022-10-31
fe62ddeb911b8e9d,,86739887,1771575,0,0,88511462,2022-10-31
b5f8ff7877d692df,,428893519,2767405,0,0,431660924,2022-10-31
c6cf01a96fb00743,,170772812,2504112,0,0,173276924,2022-10-31
8f738228f6d67e3f,,86711850,2075051,0,0,88786901,2022-10-31
132987459674f26a,,311793561,3990865,0,0,315784426,2022-10-31
921453f86f53e94e,t-mobile,14918268147,254021779,220446,88670,15172599042,2022-10-31
c02bfd7f5657be09,,112330887,4004799,0,0,116335686,2022-10-31
072401667b48888d,,118365936,3263235,0,0,121629171,2022-10-31
b3540ac97954bf26,mint,9937604378,53776091,17521,199432,9991597422,2022-10-31
607aa286e40bea6e,,169739230,2095726,0,0,171834956,2022-10-31
627e80408e72f339,,133610807,1839373,0,0,135450180,2022-10-31
88dec57d25eff267,,135592178,3849224,0,0,139441402,2022-10-31
026ae1dad1bf8dd8,,121900772,2450685,0,0,124351457,2022-10-31
4fa6dc4d5d8f843c,t-mobile,0,0,0,0,0,2022-11-30
e0e18e29f881cee7,t-mobile,0,0,0,0,0,2022-11-30
731e2aaabf1b00f4,,671046117,11032324,0,0,682078441,2022-11-30
e4598077b63a5691,mint,614909107,13924863,0,0,628833970,2022-11-30
b62c70be552853f9,t-mobile,0,0,0,0,0,2022-11-30
682ce9676fd407c9,,3183241216,46187863,0,0,3229429079,2022-11-30
178c979de55546ab,No network connection,31924442,691803,101508467,1565858,135690570,2022-11-30
d9f4deceb8f67e3d,verizon wireless,464351724,38334379,0,0,502686103,2022-11-30
a0b95492495071a7,verizon ,0,0,298890,926984,1225874,2022-11-30
126c2b81ac4fd6ae,Verizon ,0,0,0,0,0,2022-11-30
1effa5c7efc11d00,t-mobile,0,0,0,0,0,2022-11-30
8020c2e5fc8a352b,t-mobile,720880784,57484556,6895,2401,778374636,2022-11-30
7dad1c5805468702,t-mobile,0,0,0,0,0,2022-11-30
b78155d0a811134b,,781991,247718,685226,224164,1939099,2022-11-30
868d1205e2bedb60,cricket,0,0,0,0,0,2022-11-30
c15f21dfde308823,,0,357,0,0,357,2022-11-30
ca0f0a660930a6d7,cell one of ne colorado,0,0,0,0,0,2022-11-30
238c14aedb3787cb,mint,3871540730,73395444,93651,34187,3945064012,2022-11-30
d6d745898bffbbb0,,125748327,2154547,19675710,1010442,148589026,2022-11-30
206920e67c1f0a3a,at&t,0,0,665541,213967,879508,2022-11-30
a48ee793ba3d0b6a,t-mobile,12546320538,285884558,6853,2343,12832214292,2022-11-30
1c1af400cf356a93,t-mobile,0,0,0,0,0,2022-11-30
9c044b44e96910ea,t-mobile,0,0,0,0,0,2022-11-30
2d9b66608c6ddaf8,,1002350267,17413116,0,0,1019763383,2022-10-31
fb5aeea72a2c5a75,t-mobile,583005,255008,0,0,838013,2022-10-31
55fe1a21c2301440,t-mobile,0,0,199236312,5762158,204998470,2022-10-31
e3299e04704fc182,,91005258,2716671,0,0,93721929,2022-10-31
21d5b9c1b5e5d392,home,854318,259278,0,0,1113596,2022-10-31
67baf0215d61a256,t-mobile,0,0,0,0,0,2022-10-31
25c34ff52599c8f1,verizon ,22234969,3257352,1178443,282470,26953234,2022-10-31
49b38d46a4d1dd3d,verizon ,8665641267,223366003,144291,43812,8889195373,2022-10-31
779803e3c757de6a,Verizon ,783048920,11415137,125865997,3688645,924018699,2022-10-31
8c05a46e734f05aa,verizon ,216462774,3940758,311023,100750,220815305,2022-10-31
9ebf73f72b483876,,826278,291870,0,0,1118148,2022-10-31
da2e28f0f2937c63,t-mobile,0,0,0,0,0,2022-10-31
8ecf1ae70953f508,mint,76954932,1955252,100920,31549,79042653,2022-10-31
479852624dd237d2,,897918050,20674755,0,0,918592805,2022-10-31
cc3e12dc1362a37e,t-mobile,1088171645,116478147,14556,4113,1204668461,2022-10-31
3754029f1ee576e0,t-mobile,0,0,3875549,354457,4230006,2022-10-31
fc2def0a62f3ea33,,183800224,3257033,0,0,187057257,2022-10-31
ce5c8f232989f5be,cricket,0,0,537605,178305,715910,2022-10-31
e9ece0dcbf332ecf,t-mobile,2975805399,52474232,26799,262570,3028569000,2022-10-31
042e5dfa23922f4a,t-mobile,41030940945,653215503,904931,125691,41685187070,2022-10-31
06ecbd2603eadda2,t-mobile,378134222,41421141,1492956,181033,421229352,2022-10-31
7224fb9f21ef7d31,,493070067,9611900,0,0,502681967,2022-10-31
195d7af07c4d3460,t-mobile,2275710157,76432729,1622657,187031,2353952574,2022-10-31
4f69e30e88d2a653,,54380881,885592,42933,27579,55336985,2022-10-31
97f59644ab9f1b2f,t-mobile,9558511831,175441007,3768198,475891,9738196927,2022-10-31
e23d1f018c10f977,t-mobile,1199900772,73192953,1365,9531,1273104621,2022-10-31
49d8a3918a3b3a5d,t-mobile,771943,284098,3903694,159828,5119563,2022-10-31
a008ec673362fd24,t-mobile,0,0,0,0,0,2022-10-31
e9d298cb56f3b126,,602616203,48452420,258645,85721,651412989,2022-10-31
e800fb5c9214c355,,363908750,26778313,108825,830745,391626633,2022-10-31
9fc474c8d14c76a2,t-mobile,181983,39734,71648454,2474262,74344433,2022-10-31
3f5893eaad6dece6,t-mobile,0,0,752740,94432,847172,2022-10-31
0eb9e63acffc9205,,543864673,10474442,0,0,554339115,2022-10-31
8208a1c37ca00d04,,155989463,2711705,0,0,158701168,2022-10-31
d0fe239f8354629c,,67370981,1555527,0,0,68926508,2022-10-31
626fb2c7b7fbc723,at&t,603289517,45791969,1813850,637909,651533245,2022-10-31
31f29c29e8764573,credo,5335047396,102626006,926172,106337,5438705911,2022-10-31
55cb840b45a153ab,spectrum,3835721937,129336538,6661,1741,3965066877,2022-10-31
51977570c994701c,mint,2816570630,86199058,0,130,2902769818,2022-10-31
50ed3ccf4ed2c592,xfinity mobile,3826430220,123366600,1115734,202804,3951115358,2022-10-31
12f09eb39ab6807a,mint,2051826215,42703780,1315105,324559,2096169659,2022-10-31
8a5d5191c72a70a0,,170977311,5737882,0,0,176715193,2022-10-31
f48d063d26c7bea6,verizon wireless,1002603686,21366726,1292814,69009,1025332235,2022-10-31
4c243fe152edf391,,106151332,1359433,0,0,107510765,2022-10-31
3c6ef2abb585958a,verizon ,120129758,11965643,711573,63590,132870564,2022-10-31
29277a6d6021325e,,154831801,2646878,0,0,157478679,2022-10-31
4cfeb78dea0ef9e4,,155025650,2134878,0,0,157160528,2022-10-31
42b74b8d1008fc28,,154478693,1761152,0,0,156239845,2022-10-31
aadcbc18401d1fed,,155982213,2596963,0,0,158579176,2022-10-31
5a414cbcefc6f46a,,154712958,1384993,0,0,156097951,2022-10-31
66da10fda041d5a4,,154327511,2747862,0,0,157075373,2022-10-31
8806a65eaa262bad,,154261682,2578690,0,0,156840372,2022-10-31
3f3df80c6836d1cc,,157045825,1674311,0,0,158720136,2022-10-31
d2c424b05c6bba2b,,154403737,2216048,0,0,156619785,2022-10-31
eb04f59cd871b3a2,,154358361,1985802,0,0,156344163,2022-10-31
e58f55029842ccfd,,933043762,37904891,0,0,970948653,2022-10-31
282d37abfe1666cc,,1667905411,44519174,0,0,1712424585,2022-10-31
9b43e10ca53c2d99,mint,1813704357,44502527,1571,1157,1858209612,2022-10-31
32ea4aa2bd7ce7b2,t-mobile,6750573414,72970627,0,144,6823544185,2022-10-31
482de604eb82fafc,,163404726,3825337,0,0,167230063,2022-10-31
6c3621049ab9058d,,82619632,2368937,0,0,84988569,2022-10-31
088c15ca6436def3,at&t,2988412122,70135720,6829,1481,3058556152,2022-10-31
9638f27a6b02a65b,verizon ,1769980446,60554521,746187,77745,1831358899,2022-10-31
60a40876a67f0f24,,87250244,1733729,0,0,88983973,2022-10-31
82d50a9e4aaf077f,,163591059,2550578,0,0,166141637,2022-10-31
78cebeec715e84d3,,214991203,4230417,0,0,219221620,2022-10-31
acd6d6ddbd0b1417,,189115238,4120695,0,0,193235933,2022-10-31
128f53f8c5a93911,,244528804,2380450,0,0,246909254,2022-10-31
89143a239063ed58,t-mobile,6635287993,64851342,3277675,615260,6704032270,2022-10-31
bd7f6cefd1f154b7,,68177361,2586300,0,0,70763661,2022-10-31
9790d56a3112e72e,,76641019,2785300,0,0,79426319,2022-10-31
e7ae28ddebe9c74e,,57389306,2283763,0,0,59673069,2022-10-31
129b1205dedc5d79,,188979849,2248844,0,0,191228693,2022-10-31
de321735a31d8fd6,,68694147,2558389,0,0,71252536,2022-10-31
977f6a1931caf8fc,,287176244,7086065,0,0,294262309,2022-10-31
8d864c91a9bc5536,,135760314,2494489,0,0,138254803,2022-10-31
a15b8afbeff6d321,,7156569879,140450652,0,0,7297020531,2022-11-30
6e801b7ce58a3f5b,t-mobile,26539218,4512198,0,595,31052011,2022-11-30
d3494aacb5f6eb44,t-mobile,635019687,13364881,914114,292853,649591535,2022-11-30
057ae0591c9666c6,mint,868281,267420,265175,76911,1477787,2022-11-30
733e8854fb4e28fc,verizon ,179631891,7726207,16913,6843,187381854,2022-11-30
be1abe901b41b248,Verizon ,1331556627,20037633,16745,5100,1351616105,2022-11-30
b613f3406a75cc39,verizon ,18871627494,345415279,16538,9864,19217069175,2022-11-30
218f62dff360704d,verizon,0,0,0,0,0,2022-11-30
bc6e7821fe69a59c,verizon ,24501774432,380120121,13049,2041,24881909643,2022-11-30
cda5fd3e15f57538,verizon ,0,0,0,0,0,2022-11-30
ff4047a9de239b3c,t-mobile,0,0,0,0,0,2022-11-30
1c90532868bb73fa,t-mobile,324836231,5545667,18868,12629,330413395,2022-11-30
c1f9b0055877390e,at&t,802806307,19724542,925174,46888,823502911,2022-11-30
4ddb5cb7e2652127,metro by t-mobile,0,0,0,0,0,2022-11-30
b185137a4c9d248e,t-mobile,3379607064,85245744,111406,59551,3465023765,2022-11-30
97043105a12c5af4,,401752951,35941582,0,0,437694533,2022-11-30
6b33cb93c209a977,t-mobile,0,0,0,0,0,2022-11-30
911f6e9ad73c3a9d,cricket,0,0,0,0,0,2022-11-30
def9bfbf6b0c6708,metro by t-mobile,84351214106,1354265639,851262,191560,85706522567,2022-11-30
ea851fb43a3f966b,,255631217,6287986,0,0,261919203,2022-11-30
2170e49f0e129fae,,197927,77806,0,0,275733,2022-11-30
821be397658455fb,t-mobile,28045115191,480031538,1045,7254,28525155028,2022-11-30
139a2185f3bb16b3,t-mobile,0,0,138,162,300,2022-11-30
f2185f3e068ebbf9,t-mobile,0,0,0,0,0,2022-10-31
1b0b0b6a6a370706,t-mobile,0,0,0,0,0,2022-10-31
85e3178b368fed14,grameenphone,3714963,526223,0,0,4241186,2022-10-31
3f6d0557e107c1be,t-mobile,76842622,1196655,325995,148050,78513322,2022-10-31
c8227714a84a4e36,home,0,0,0,0,0,2022-10-31
5abd42b369f0ab60,t-mobile,213288,54868,32316,8760,309232,2022-10-31
5e8fcbb7f1179761,Verizon ,18832867618,348123935,958404,143900,19182093857,2022-10-31
c2a4d723dca12767,verizon ,626124,574322,208077,55547,1464070,2022-10-31
49152f15fcfbb4d2,,449242316,22550619,0,0,471792935,2022-10-31
0a6979e4f2bc8b1f,,4627843174,56974845,0,0,4684818019,2022-10-31
9c707dea9968bc41,t-mobile,0,0,0,0,0,2022-10-31
79890dbd53ac18a3,,36969,131526,0,0,168495,2022-10-31
56e4f64ea0b8651f,t-mobile,0,0,0,0,0,2022-10-31
c0514d6e952050ce,,523408850,38362355,183753,11519,561966477,2022-10-31
ba126bb9dab142b0,,294401,182515,2365443,1688456,4530815,2022-10-31
3e13dbf1892a0d40,t-mobile,0,0,45054,188970,234024,2022-10-31
eeb2e41876664c9f,t-mobile,723688797,48660354,0,0,772349151,2022-10-31
53d004d951f3f857,t-mobile,0,0,0,0,0,2022-10-31
11ef12ebd95ce380,t-mobile,535064885,10681118,20095432,378261,566219696,2022-10-31
fe15c3cf5435572f,t-mobile,26411120104,509286527,219404,81360,26920707395,2022-10-31
37e9e1c08b78533c,t-mobile,0,0,0,0,0,2022-10-31
2a69a5ba1cdd406f,,2725,6317,0,0,9042,2022-10-31
cc2729a348f2ce2c,t-mobile,31693657854,508430011,105468,24241,32202217574,2022-10-31
f6a385d09f655fa7,t-mobile,4582677920,117985814,7690,2070,4700673494,2022-10-31
16a73c60b5558757,,546521,177211,705079,232475,1661286,2022-10-31
adcf4e63a45fc728,t-mobile,765822944,16411773,53633061,2579163,838446941,2022-10-31
0d9737b8d8dea7f1,t-mobile,131440569,9508944,157609,55000,141162122,2022-10-31
44ffb73a9e3b7099,,893988,278307,0,0,1172295,2022-10-31
4786127f2544ad19,,2201369473,87729432,19501,6123,2289124529,2022-10-31
8371190d9dd21ccf,t-mobile,34200839,1335929,570226,189563,36296557,2022-10-31
cf17b1b10d723006,,406001099,8220890,0,0,414221989,2022-10-31
43265bc5575052a2,,601958743,10907490,0,0,612866233,2022-10-31
4bf997cf7faf5ead,verizon ,8757203609,150745912,227129,119607,8908296257,2022-10-31
246ce55eb6c10a8c,mint,922667583,66251807,943440,136745,989999575,2022-10-31
78e08da84ce93331,mint,0,0,0,0,0,2022-11-30
b6c358d27b3b06f3,verizon ,49721669,1266892,163881,61970,51214412,2022-11-30
da13a84d4966817c,mint,75957601,1331942,51361,256915,77597819,2022-11-30
065e204e48046d06,t-mobile,342426535,19591200,14718,5744,362038197,2022-11-30
bfa41c2585bc7320,mint,856866091,17619998,0,0,874486089,2022-11-30
7c47d815e0c84665,,173923678,10036885,0,85,183960648,2022-11-30
15e3b3992be1f004,mint,115092137,1539648,824320,261146,117717251,2022-11-30
372375a80bffdd37,,221990048,3718694,0,0,225708742,2022-11-30
4c0022910891fab3,t-mobile,876475226,71534518,0,170,948009914,2022-11-30
1dd79ed75db080c3,verizon ,0,0,1601245,269336,1870581,2022-11-30
8a09210a5d302fd5,verizon ,831982896,46818883,2022494,250669,881074942,2022-11-30
e9523ca70c04ed20,,235738,71800,0,0,307538,2022-11-30
b0a7baf8bc026e4b,,896570,295036,283940,93191,1568737,2022-11-30
c0ab80660b1ec855,cricket,1632637832,39713118,0,0,1672350950,2022-11-30
512146075afd7a5b,,27366609,5229544,0,0,32596153,2022-11-30
ab7316526501f383,,709029,190731,293548,76018,1269326,2022-11-30
8cbdec83a99320d0,at&t,462331379,38126117,1684665,260195,502402356,2022-11-30
a094956054f139c4,t-mobile,1482718641,55149789,999582,142837,1539010849,2022-11-30
c5d5a94b541393af,verizon ,502943607,62939249,15330,3392,565901578,2022-11-30
a470117ef5e95348,at&t,1070738785,75262104,683775,23631,1146708295,2022-11-30
64cc3b3c470aecfb,,355402130,4405832,0,0,359807962,2022-11-30
71acafe68a22d3c5,Â ,913552886,63227297,0,0,976780183,2022-11-30
c96a32b55a3e9bfd,verizon ,794526367,48171093,403053,124544,843225057,2022-11-30
300ccac9c110858d,us  mobile,830157933,76238625,112300,43608,906552466,2022-11-30
afe5d1ba2f8489ad,Â ,85216259,4035912,2068404,290141,91610716,2022-11-30
a3cb947d8fc2ab9a,,509993581,11743099,0,0,521736680,2022-11-30
2977361a3e689e96,at&t,784078010,12854884,1246973,88975,798268842,2022-11-30
d7ed2c2ee011c86c,verizon ,474709165,36801687,1142327,176016,512829195,2022-11-30
876d32fd1ffbc305,,990589827,85899648,6468,1584,1076497527,2022-11-30
79247e70656ad069,verizon ,615880700,58745274,939638,130379,675695991,2022-11-30
abbe62465b6b47d8,at&t,296833222,28661028,84,84,325494418,2022-11-30
96e1e35f7c226254,verizon ,0,0,33552,7141,40693,2022-11-30
b4ba68124ead87b9,at&t,2097076136,68288936,669285,28325,2166062682,2022-11-30
afd63b4f280c3e91,,127972747,3454074,0,0,131426821,2022-11-30
3456a884acb38e3e,at&t,337139498,54444810,436,510,391585254,2022-11-30
65301b6261bf7114,t-mobile,1265660378,55967495,20730,6998,1321655601,2022-11-30
eb513f7d79735933,t-mobile,826185879,110227980,90589,29837,936534285,2022-11-30
e491ac2cdfac5e4c,t-mobile,0,0,1384472,78900,1463372,2022-11-30
d5c2580ac04532f5,t-mobile,1087020391,42235441,0,0,1129255832,2022-11-30
92cea3ec6d00011f,t-mobile,213286113,17692943,0,0,230979056,2022-11-30
4ae61621c9635ad6,mint,741690929,53454337,6557,1951,795153774,2022-11-30
5ff520c93f1941be,,252550904,23520443,0,0,276071347,2022-11-30
a5df8b3095719fd6,,2037451962,33772055,0,0,2071224017,2022-11-30
d85687856cb56843,mint,1725582011,67157099,858463,109398,1793706971,2022-11-30
2126b54d2adc74b0,t-mobile,864597014,57011721,1641906,273750,923524391,2022-11-30
49fb403121e15bf0,mint,141864381,7791148,632999,22961,150311489,2022-11-30
8f398bd8982ad499,mint,0,0,737332,83323,820655,2022-11-30
3ffb87418a7c1e08,t-mobile,685108383,55478310,1080817,157466,741824976,2022-11-30
8e0d861a883d11b1,mint,431758697,50061162,1156237,235461,483211557,2022-11-30
1e45e6a113b04fc7,,147520693,1715748,0,0,149236441,2022-11-30
f45fd2988730f13b,mint,638015570,50617515,1424260,107311,690164656,2022-11-30
7b116588b4449bc4,mint,596643567,61397855,0,38,658041460,2022-11-30
3caccb6f641a57ab,mint,849796351,73029488,6756,2105,922834700,2022-11-30
4780ba482ca66b7a,,84355981,791790,262454,78680,85488905,2022-11-30
f7b27ad2d2ff25b0,t-mobile,413745591,39764346,694982,167707,454372626,2022-11-30
f34fd288af510979,mint,394223775,35833737,319898,42287,430419697,2022-11-30
7ea19eda35ffc88e,t-mobile,1248921351,77551147,1567225,167136,1328206859,2022-11-30
28b68cfb44b5531d,mint,6377252483,115429476,14210,2435,6492698604,2022-11-30
63299da064e5880d,mint,459282679,44834013,1765955,216284,506098931,2022-11-30
8baf9c7aeb1d671b,,127288254,2529964,0,0,129818218,2022-11-30
fcab4519e2cbc675,mint,790665998,79885436,851839,114313,871517586,2022-11-30
b96724e9d88cf38d,mint,174688892,18499433,1533520,293205,195015050,2022-11-30
aa88122175cd3f77,,168,168,0,0,336,2022-11-30
92d1007d6b31eb7f,mint,448914771,47761984,607,3651,496681013,2022-11-30
a2c4d6e3c1f9cf2f,,262928540,4155262,0,0,267083802,2022-11-30
fa53ca8bf76fd18a,mint,157565837,18363476,48003,12766,175990082,2022-11-30
3d08684db15a5b47,,402629,107264,3068,1757,514718,2022-11-30
8dc116df6c59080a,,145823453,2098071,0,0,147921524,2022-11-30
753bc3101ba422f2,t-mobile,173932840,5978603,700645,138445,180750533,2022-11-30
cb07fac09e87a024,mint,768423956,73032713,153936,61145,841671750,2022-11-30
8e4916c4e48ee475,,595650633,43318563,2671113,980478,642620787,2022-11-30
4f551379b320b6a2,,712189,213588,15498,4472,945747,2022-11-30
a3cfafbb768053a0,,42376992,6795207,0,0,49172199,2022-11-30
94d70f844f5364c6,mint,122578666,1660252,1810382,338929,126388229,2022-11-30
4a3ed6161c127eae,,303001779,4386439,0,0,307388218,2022-11-30
9e62e2bde2a4ae7e,mint,659206900,73904613,53021,488625,733653159,2022-11-30
69c8dee50e2fab52,mint,138654685,22172311,617158,22027,161466181,2022-11-30
84d6f32aeceb1953,,39638721,1581933,0,0,41220654,2022-11-30
1953d05c80bfa03b,mint,482456947,20182952,0,85,502639984,2022-11-30
8dd7836dc2039ffd,mint,775653914,75685720,0,0,851339634,2022-11-30
69cb702523cba63d,mint,634533816,72940424,21789163,757697,730021100,2022-11-30
175443c4f2543341,ting,105769,28658,658573,200548,993548,2022-11-30
1a20a84b0d252bb4,,253724172,4298218,0,0,258022390,2022-11-30
392ef3ced563912e,mint,321646354,20279746,910992,522029,343359121,2022-11-30
fec72308d5f39604,,340648174,22292497,0,0,362940671,2022-11-30
7360f30e9bc8d4a9,mint,1130527776,72669510,959759,149428,1204306473,2022-11-30
942411cd2b355f5a,verizon ,1129372771,46854342,2891646,437047,1179555806,2022-11-30
af47ef3f62baa055,,618956,108861,55271874,1570728,57570419,2022-11-30
e62342ef35c9459e,t-mobile,2156595388,102138830,45633,21315,2258801166,2022-11-30
646be13df22af337,at&t,0,0,37183,15393,52576,2022-11-30
61a0bcceb267f0e8,verizon ,798512616,74061256,11932,1521,872587325,2022-11-30
82b2c91d71ae21f5,mint,793685337,33398399,2618452,959700,830661888,2022-11-30
9a340e70c81f1f67,at&t,243384066,49724908,0,300,293109274,2022-11-30
e5dcd6c230424761,verizon ,138898301,14287463,1399684,252063,154837511,2022-11-30
f012ea8ea511e6b4,at&t,736414159,8188096,1212038,130091,745944384,2022-11-30
1604498ab30e3b59,at&t,2379894629,90234548,875983,103759,2471108919,2022-11-30
4040ab020be1966a,t-mobile,0,0,56826,12372,69198,2022-11-30
91f0ae7d8c185e3c,t-mobile,651068206,81545577,560811,46726,733221320,2022-11-30
594b15751e9bcb38,verizon ,803043255,59151309,131637,46418,862372619,2022-11-30
d1f219d9edb8898a,at&t,2287260370,45269846,1332536,265782,2334128534,2022-10-31
045226739dca13ca,home,8023311810,160236097,1110042,195527,8184853476,2022-10-31
e8e62a28b6d098b1,at&t,1749530131,95703404,664366,36437,1845934338,2022-10-31
cbcfa2bd32511933,verizon ,4436523618,108099644,1290521,307155,4546220938,2022-10-31
31afbde5b0ae105e,spectrum,339684216,12661937,33770,8883,352388806,2022-10-31
095c098f67008f73,cricket,1726691718,59929344,1300292,130467,1788051821,2022-10-31
419e73effa1d0c8e,verizon ,1560222445,45590427,741440,61646,1606615958,2022-10-31
f4571e05a4570b50,,242678906,3440951,0,0,246119857,2022-10-31
d40fb692674bf08c,,480584181,67193695,13609,4844,547796329,2022-10-31
b29e19375bf2960f,,154296836,1932251,0,0,156229087,2022-10-31
b012e4e0f145c87f,,154492388,2049720,0,0,156542108,2022-10-31
63768f7ed3e59f69,,168143954,1591197,0,0,169735151,2022-10-31
61f5687bbd8121ac,,155786416,1935907,0,0,157722323,2022-10-31
077b4b2d0133cbc3,,154431803,1788762,0,0,156220565,2022-10-31
e485d0d1e2cc1a48,,154333080,2186126,0,0,156519206,2022-10-31
80b6d993c540ead2,,156092910,1601931,0,0,157694841,2022-10-31
15e47524f9462ea0,,155604707,2415447,0,0,158020154,2022-10-31
8c18f967013057da,,154320479,2946477,0,0,157266956,2022-10-31
310daa3645f5211a,,155139751,2070028,0,0,157209779,2022-10-31
66297ceae95b9dcb,verizon ,6072920804,102293876,1745052,192658,6177152390,2022-10-31
4137f3e9832187bf,verizon ,1301613750,34255557,63200,19015,1335951522,2022-10-31
4ff30bd261be0bb2,,155091134,3657992,0,0,158749126,2022-10-31
98e325bb79ab1699,verizon ,1001614875,25261174,0,0,1026876049,2022-10-31
232f3c91b23e9fdb,mint,3396285190,87569836,84,84,3483855194,2022-10-31
0c4841bde6e62f55,,177875417,3551458,0,0,181426875,2022-10-31
6e65204a8b285787,mint,1819474024,62694760,2582995,459870,1885211649,2022-10-31
0b0c5dfbf08e4371,verizon ,7498484216,158755275,1545884,337456,7659122831,2022-10-31
b7feb358ea8665d4,,109445402,2286193,0,0,111731595,2022-10-31
0454bc7335265c7e,,177776932,2715283,0,0,180492215,2022-10-31
3e24ce08aec908fd,,164983899,3318779,0,0,168302678,2022-10-31
839a20868b71accc,,187102651,3376412,0,0,190479063,2022-10-31
14be2b163639b7a6,,306219741,3084794,0,0,309304535,2022-10-31
8e8bbbc22f822a0b,mint,810755376,21380293,1144832,218922,833499423,2022-10-31
01deffa3e7533f04,,104742394,2844094,0,0,107586488,2022-10-31
263688fa2783ee0e,,118098158,4058015,0,0,122156173,2022-10-31
a238e8f530932274,,62767776,2337695,0,0,65105471,2022-10-31
cd817baf0faa9fbe,,189506170,1974398,0,0,191480568,2022-10-31
5f958b8baafd02be,,78857789,2729497,0,0,81587286,2022-10-31
deb204294a48b288,,219339269,4629100,0,0,223968369,2022-10-31
3fa34c2d13e06acc,,158881345,3079702,0,0,161961047,2022-10-31
5c7b66fc2cb4b396,t-mobile,33251,7748,12151,2422,55572,2022-11-30
d2ff2e5f1e237039,,2811162425,49964333,0,0,2861126758,2022-11-30
567fbea49f98bf0f,,889437,343090,0,0,1232527,2022-11-30
35a2b341a69abbdc,,173399290,3138814,70462465,1053875,248054444,2022-11-30
0efb3ba8cf6d8483,verizon wireless,0,0,0,0,0,2022-11-30
94cff239b108f5a5,verizon ,24880461,307286,22768575,545917,48502239,2022-11-30
f9327388193c730b,Verizon ,744912,200642,475206,148276,1569036,2022-11-30
c6ef88cbae245e68,,493211210,47608916,45841,18743,540884710,2022-11-30
0ea620b8d5ffecad,verizon ,403693109,42623215,193192,71980,446581496,2022-11-30
95a61864ac0ef2ec,Verizon ,60337,21775,98185,51678,231975,2022-11-30
f7182de922cc457b,,823904,272147,512000,198735,1806786,2022-11-30
4c98c2392336c884,t-mobile,0,0,0,0,0,2022-11-30
0bafbef91fc2152b,,1033429786,36971575,0,0,1070401361,2022-11-30
26d5c1409f099cea,t-mobile,0,0,0,0,0,2022-11-30
7871f9e9d1f0cbab,at&t,0,0,884523,131024,1015547,2022-11-30
8a5d7983c178a5f3,,1070560,402139,907411,358780,2738890,2022-11-30
3f64bf1a67083351,,68889580,1171168,69284243,1271943,140616934,2022-11-30
f68aacb7ac3bdba4,,99985108,1877607,0,0,101862715,2022-11-30
01f85217507c9623,,100486977,8827150,71805,1984826,111370758,2022-11-30
36d08352d6bd9706,t-mobile,6137831,175597,481651,195394,6990473,2022-11-30
f8cb0532ab7ca981,verizon ,0,0,0,0,0,2022-11-30
ff762d7137ce9a46,,1735658624,44301602,0,0,1779960226,2022-11-30
afd034aba21a5dab,,19241651545,337400612,1547797,425658,19581025612,2022-11-30
dfc9261fb1412df6,t-mobile,243705,90166,0,0,333871,2022-11-30
73d2ab971c3add16,t-mobile,16657191617,316252156,726781,77549,16974248103,2022-10-31
3f6b252fe3b61414,t-mobile,812203,274273,550540,230122,1867138,2022-10-31
59cded7cd28468c1,t-mobile,0,0,0,0,0,2022-10-31
957ec9e3eb18687d,t-mobile,393273036,6839703,357153,596931,401066823,2022-10-31
efb14714c3b3abf8,at&t,262657259,3748078,3867274,390391,270663002,2022-10-31
3a1a454625c93473,t-mobile,22647371142,408750012,1094436,218425,23057434015,2022-10-31
0fc7667f78b7cdad,,906953161,41831211,0,0,948784372,2022-10-31
06da655c13eb56c7,verizon,0,0,0,0,0,2022-10-31
310283bb754ecf03,verizon ,465565053,37534623,581603,1096561,504777840,2022-10-31
966c6b26f9bf7db6,verizon ,38389,10860,3455848,1320678,4825775,2022-10-31
69e3852758dd005c,t-mobile,0,0,0,0,0,2022-10-31
90cadf6453e1dd56,,734677153,17814101,0,0,752491254,2022-10-31
65f201f0db3cc269,t-mobile,779376,219296,0,0,998672,2022-10-31
da56f7cd3042a888,gsma,1752052626,65052800,1710358,967484,1819783268,2022-10-31
fee1c703ab94e25f,mint,31726457,4793776,0,0,36520233,2022-10-31
aaf4ed2f5678cfbe,t-mobile,0,0,0,0,0,2022-10-31
305e7d609d40d227,,19921648,1210961,77889,47471,21257969,2022-10-31
b5bed6e1886b1cc7,t-mobile,0,0,0,0,0,2022-10-31
aa3abca1484f3c3e,,109845436,4428691,0,0,114274127,2022-10-31
994a30241b258ab1,t-mobile,0,0,0,0,0,2022-10-31
8c83adfeb325c05f,t-mobile,0,0,827562,108254,935816,2022-10-31
dda562a77dc37fec,,361840765,13261198,0,0,375101963,2022-10-31
e11373762965df18,t-mobile,0,0,252585,75306,327891,2022-10-31
106abc61e79250a1,,661941314,75980143,0,0,737921457,2022-10-31
482156e0e9148a4f,t-mobile,0,0,0,0,0,2022-10-31
7a9ffaafa7ac9553,at&t,0,0,0,0,0,2022-10-31
55b4111801149861,t-mobile,750468528,64499365,135234,56018,815159145,2022-10-31
6752ede6585d0c7a,,962901114,71893130,0,0,1034794244,2022-10-31
868a80719201edc6,t-mobile,0,0,0,0,0,2022-10-31
4a057ecfce9ad354,t-mobile,292272816,12247116,909406,126455,305555793,2022-10-31
81ef14ff148890b9,t-mobile,980580,196088,119209,39074,1334951,2022-10-31
c19f00639ae44817,t-mobile,0,0,0,0,0,2022-10-31
cdf113945db8a195,verizon ,507989659,44996624,693742,132894,553812919,2022-10-31
af30d488395b9b46,t-mobile,0,0,0,0,0,2022-10-31
02b47432c82d6200,t-mobile,125987278,8797552,0,0,134784830,2022-10-31
3cac6a523cd13472,t-mobile,0,0,0,0,0,2022-10-31
846f7f7d55c5fad5,,17325912,1030898,0,0,18356810,2022-10-31
74622bad4b75ca12,verizon wireless,631010351,56828877,64018,19431,687922677,2022-11-30
2f78d9c8b711e317,,970258832,155884970,1281442,186161,1127611405,2022-11-30
ff91f2955c287b80,at&t,0,0,1399499,56748,1456247,2022-11-30
2657ba09d77739ff,t-mobile,1554599901,85584262,41318,12206,1640237687,2022-11-30
47055213a8c3fe88,,170444722,4701741,0,0,175146463,2022-11-30
7fee6ee653013d6d,verizon ,738924652,78944016,142816,48386,818059870,2022-11-30
815040c95791d9fa,t-mobile,423426757,36752983,2290,22778,460204808,2022-11-30
459ad90a2d1471df,verizon ,346447809,11286782,2140147,327433,360202171,2022-11-30
71c90bce5f32ca0f,verizon ,511598976,55810081,91481,27627,567528165,2022-11-30
687f58c3b4899a73,,147135671,18576430,0,0,165712101,2022-11-30
1159972e1150156d,at&t,508448063,52840609,221630,73903,561584205,2022-11-30
e0abee1302fead72,at&t,182343006,13640932,84,84,195984106,2022-11-30
18a3ac68ba116078,at&t,798641747,88967855,9059,168266,887786927,2022-11-30
909803c5ab9f85f9,at&t,1129350732,39167060,701965,53460,1169273217,2022-11-30
bba171ab3777793b,,1979383787,118076255,260132,95736,2097815910,2022-11-30
d56c04d0a23214ca,t-mobile,769093469,71370236,47557,11757,840523019,2022-11-30
3b6bd5095fc2cdda,verizon ,779087663,82325928,1114599,185132,862713322,2022-11-30
a2914aec7f14b557,mint,624797214,69595021,102741,33266,694528242,2022-11-30
defc28976053e39f,verizon ,1014239817,91970021,56807,17639,1106284284,2022-11-30
26ee6e2868d39514,,94892367,14991950,0,0,109884317,2022-11-30
dba69b38631b16ce,mint,202200496,3890390,0,0,206090886,2022-11-30
81f93017fe60f4b3,mint,1014054286,45080270,892570,159169,1060186295,2022-11-30
a4e2893a62779ea2,,970558663,9082265,0,0,979640928,2022-11-30
0e936a03b8617688,mint,1036101888,44895398,96207,41608,1081135101,2022-11-30
70889bc8bf0b6896,t-mobile,61680292,2150041,825293,117104,64772730,2022-11-30
1d56bce8c5236d3e,mint,709103,195724,718658,214060,1837545,2022-11-30
c9ae46ecf4e5b5ca,mint,198170209,17255656,89513,32404,215547782,2022-11-30
8d27cf17fd7085f6,mint,606345440,52173119,6672,1948,658527179,2022-11-30
7256087793a16935,mint,209219863,7165614,378411,105927,216869815,2022-11-30
dee78f55362eef01,t-mobile,440563820,44563015,14066,3963,485144864,2022-11-30
755c118236fa5835,metro by t-mobile,538845496,49251240,6565,1948,588105249,2022-11-30
6e8b2469b6d6de09,,172463818,3761810,0,0,176225628,2022-11-30
f471a3f4f021b1f4,mint,426507090,6587298,0,0,433094388,2022-11-30
af38e3779c2a2a24,mint,719306233,78820617,8498,3614,798138962,2022-11-30
93a6b48a8c9f1154,,513694382,11799032,19962,3750,525517126,2022-11-30
137222bc426ef45b,t-mobile,701663163,51810952,28074,19463,753521652,2022-11-30
d5bb467e3610f426,tello,145662068,9975359,1995096,304318,157936841,2022-11-30
ec8597eefd972b9d,,159592142,4111401,0,0,163703543,2022-11-30
25afb258484fb3d5,,110609,249885,0,0,360494,2022-11-30
aa6f353a7645027b,,285184970,6940058,0,0,292125028,2022-11-30
20eb8d8ec9f85b7b,,662701353,49490467,49336,279794,712520950,2022-11-30
8706ddedc3c9bc0e,verizon ,901624296,69871591,1413485,85936,972995308,2022-11-30
333b0aa8550129a7,gsma,481069490,23524748,1397256,74366,506065860,2022-11-30
a0b355ce03976bff,mint,176099,1274134,38510,20565,1509308,2022-11-30
de0c4d9251906405,,131979686,2790756,0,0,134770442,2022-11-30
b52eff1fc9182523,,151921686,2285631,0,0,154207317,2022-11-30
b7034830c85c0997,verizon ,618808349,56159455,450,170,674968424,2022-11-30
e6a38575920f83d6,verizon ,250207,1096005,30418,8961,1385591,2022-11-30
b59ab4927d9f010c,verizon ,945788349,68139069,1396244,293977,1015617639,2022-11-30
5af2f62673ffc915,at&t,816908848,54154482,1616751,862522,873542603,2022-11-30
2b6528a2f669b439,verizon ,2022679941,93605864,3925,1987,2116291717,2022-11-30
49fc291c84968a7c,verizon ,0,0,21445508,1193138,22638646,2022-11-30
f77d12972b5ea5d6,t-mobile,1725241528,80202383,21511,7197,1805472619,2022-11-30
70b4548f3b2a9e31,at&t,323865788,40648320,10969,17143,364542220,2022-11-30
042b502349caa174,verizon ,5732292636,93568681,846178,47436,5826754931,2022-11-30
7c1cd34a7d70650b,at&t,674007938,68206734,6675,1683,742223030,2022-11-30
dec1c491478e48c1,verizon ,1465450239,70707568,0,0,1536157807,2022-11-30
6b7da38746b633d7,t-mobile,672992110,43409509,95768,32445,716529832,2022-11-30
822a84b56fe7ada6,at&t,551795831,45911003,20511,9970,597737315,2022-11-30
f7c3f6314fbfed2b,,184571003,12856009,7088,2807,197436907,2022-11-30
9fbd8f3de35668f5,mint,151146356,3877015,400,238,155024009,2022-11-30
a8f94c76785e757f,mint,690420896,56604886,38318,142122,747206222,2022-11-30
0f62ebc962682611,t-mobile,626346548,68803605,1279910,284371,696714434,2022-11-30
c9be25ca12edc67c,mint,1554459143,82887797,6756,1987,1637355683,2022-11-30
41def6bf9d36d357,at&t,9236127424,124404762,689587,30987,9361252760,2022-11-30
7fb4de84a99246ab,t-mobile,399990740,29263672,1016121,227350,430497883,2022-11-30
8308f6ae85c20c27,mint,202965586,17179352,1944759,423324,222513021,2022-11-30
a077113858972daa,mint,562414398,47798620,104,104,610213226,2022-11-30
83803c657150dc83,mint,1517667815,77381134,2048821,277979,1597375749,2022-11-30
0fd8260757202aec,t-mobile,692222660,60066680,712605,58033,753059978,2022-11-30
8e13a66c1e8e343f,t-mobile,819205069,63911308,104,104,883116585,2022-11-30
1b003319ddb40553,,144809820,2575007,0,0,147384827,2022-11-30
379a9ec5686b8df8,mint,22966955072,465355637,498,3339,23432314546,2022-11-30
fde6c979ff6d8b0d,,197811829,22940161,0,68,220752058,2022-11-30
602165b52d401be4,mint,733423127,52255302,696468,150627,786525524,2022-11-30
f3aa72de5c816d62,mint,721805366,49278876,27752,5895,771117889,2022-11-30
5eed9d1c7bb80b48,,4132755010,110326391,0,0,4243081401,2022-11-30
87576e62f91d4bed,t-mobile,805391178,41089159,20674421,523882,867678640,2022-11-30
ef0fc62f32398fc5,mint,556459194,48984579,20675,6910,605471358,2022-11-30
d23bf44cfac2606d,t-mobile,349530331,49528414,698721,61876,399819342,2022-11-30
1c6578d9f780a690,mint,1252257784,54636911,1397080,283404,1308575179,2022-11-30
6ff1504488213da9,mint,1204037672,43966776,8174,2189,1248014811,2022-11-30
66eeae3afb9841bb,at&t,1555111955,69108658,865619,250562,1625336794,2022-11-30
12f9c4bd9074ae14,verizon ,190105807,21772222,1418142,67126,213363297,2022-11-30
c5eefb97c5f9b3e4,verizon ,878056004,63736235,176703,83179,942052121,2022-11-30
14b61f5e5dae60d6,mint,614088016,60956071,2003819,228259,677276165,2022-11-30
12e4b1add0576a22,mint,442027699,91427714,84,84,533455581,2022-11-30
13fe14247787ca16,,179569294,2372305,0,0,181941599,2022-11-30
7be26f6d47b46b57,t-mobile,2962657766,74747332,7560,6400,3037419058,2022-11-30
ff57d92766e01ddb,at&t,656165488,74930233,798939,64977,731959637,2022-11-30
09f1da8a1814f5c4,at&t,783209946,75447089,675424,40955,859373414,2022-11-30
fe527efebcf5951f,verizon ,812039536,64736998,1945922,298776,879021232,2022-11-30
1ba32918e92229eb,t-mobile,1616529579,86585771,1390117,451999,1704957466,2022-11-30
29ee51381cd3d043,mint,413024914,28206580,21376647,578370,463186511,2022-11-30
26077e4fa6fbc9db,mint,817382761,59496399,1930111,204175,879013446,2022-11-30
3cd96479f27a0286,,19188981,3222118,20240,7862,22439201,2022-11-30
fd50dd5d8180b732,verizon ,1019460074,35224352,103104,46144,1054833674,2022-11-30
8fc2062abb48f7c2,verizon ,535619080,16858205,1820365,210102,554507752,2022-11-30
cdf65f0b501422f4,verizon ,10711854212,249350175,12074,1989,10961218450,2022-11-30
e7459f4dbca212eb,verizon ,3430563608,103110953,84,84,3533674729,2022-11-30
64b29a47a085c51e,,188097700,5423864,0,0,193521564,2022-11-30
8894c56746f43093,verizon ,716459474,70442810,1419259,82410,788403953,2022-11-30
b6ee2989393b2491,mint,791056423,60692063,12293,3013,851763792,2022-11-30
e8e834bbe55feddd,at&t,914990740,29714670,20674930,438338,965818678,2022-11-30
812c7843aa5b31d9,verizon ,317946225,29660854,23642,11675,347642396,2022-11-30
b6dc05706c394974,,1223522984,32620065,0,0,1256143049,2022-11-30
4c745ddb8ed27564,at&t,1201677367,37576888,13535,3715,1239271505,2022-11-30
8ac47324f0c86b43,mint,610349207,34627311,114075,41144,645131737,2022-11-30
98f6308cf582978b,t-mobile,306260746,44919623,20551108,436521,372167998,2022-11-30
6e2f98401dd52384,mint,379779104,35443278,724030,56188,416002600,2022-11-30
2863ad46ee0f50ea,mint,818688992,62298968,0,0,880987960,2022-11-30
03e3c245efcd2789,mint,591401089,59615999,1045361,195004,652257453,2022-11-30
042048ec5fba4dab,mint,617652175,58142948,7153,2296,675804572,2022-11-30
09a165ad10d40ab6,mint,475340874,46636911,31335,7556,522016676,2022-11-30
ac8ccf2aa6343c08,mint,343127187,17261430,658,3910,360393185,2022-11-30
582b352f5cd0f818,,393628748,32763874,0,0,426392622,2022-11-30
e2b804c7b2ab5e7c,mint,376519058,35569693,727557,58934,412875242,2022-11-30
31a12003f732d0b3,mint,2714034740,86239110,67328,21128,2800362306,2022-11-30
6e2546c881249843,,109242147,2096555,0,0,111338702,2022-11-30
43f26b4dd8fdfcee,mint,998746824,37805623,7119,1654,1036561220,2022-11-30
08d17a519b1fdac0,t-mobile,390646246,42958865,1610650,843730,436059491,2022-11-30
d33f1034c8057b91,t-mobile,1314101846,68416172,28915,12839,1382559772,2022-11-30
21422749582940b6,verizon ,630741596,40279563,1075770,157815,672254744,2022-11-30
b726620cba6d0692,,920406605,43812822,0,0,964219427,2022-11-30
41c910a717506777,t-mobile,0,0,1369216,66816,1436032,2022-11-30
bf5c131b0de141d0,h2o,564147902,71530904,958986,146651,636784443,2022-11-30
3c7abdbbb37f7fe6,verizon ,594639806,58143023,6661,1741,652791231,2022-11-30
d9927e67f4b7b3a2,verizon ,270148961,42861792,21891624,509369,335411746,2022-11-30
354ef12f9901f7b8,at&t,562554540,48921130,2145851,365424,613986945,2022-11-30
46e321c09af1c5c0,mint,660654712,29156135,60977,17789,689889613,2022-11-30
57e2a4dcfe247b6f,verizon ,1207455887,68315177,675,255,1275771994,2022-11-30
b85f1b6e01ebca45,,880995340,33102919,0,0,914098259,2022-11-30
ec0d1181180fd2fb,verizon ,907228674,59939583,1389313,67591,968625161,2022-11-30
485d15f6b7ece6b1,at&t,497021727,43955813,291417,111113,541380070,2022-11-30
4fa9e6d4e9610665,mint,809710618,76824957,19465,7019,886562059,2022-11-30
34ec18c02203bb6e,t-mobile,73508270,7974104,1404804,75695,82962873,2022-11-30
42dd527f7ce210da,mint,619280023,68761582,1934745,280899,690257249,2022-11-30
d74c6e155c4ab7ca,mint,518687376,58967449,728717,84409,578467951,2022-11-30
c58112b9c4f42f06,mint,694442409,51985594,268120,96665,746792788,2022-11-30
22856fd9ada1a9f8,verizon ,0,0,1390786,97725,1488511,2022-11-30
b3f763f87c84c155,at&t,0,0,851955,78931,930886,2022-11-30
ac0b5444305c007b,mint,927522490,55579818,2026792,269423,985398523,2022-11-30
6521de1474470f03,verizon ,431377787,62493802,32066,11273,493914928,2022-11-30
da04625cdacb06e2,at&t,290052259,34565819,0,42312,324660390,2022-11-30
d7b1869aa79f05f2,verizon ,650049198,57081687,68518,21341,707220744,2022-11-30
2d59c968adef18e2,verizon ,344938458,36825789,6765,1937,381772949,2022-11-30
1c64a60220f5f6a8,verizon ,559976428,48284939,305621,256126,608823114,2022-11-30
ff4d4a850649ca8c,at&t,1068694716,95733426,82457,31573,1164542172,2022-11-30
33ebf14f924dde8d,cricket,440065291,25255775,2059778,298565,467679409,2022-11-30
b6c4f43e934f69cf,,134175978,1661200,0,0,135837178,2022-11-30
14600ba55e86b351,verizon ,6012675056,86941788,1121501,194069,6100932414,2022-11-30
9077390b6b3c603e,verizon ,1535008986,87233317,21187540,232472,1643662315,2022-11-30
679a9f26692459da,verizon ,1043947402,34603310,1424963,342230,1080317905,2022-11-30
4e04df90de72d98a,,89228682,3217305,0,0,92445987,2022-11-30
a3a296dd72db8c04,verizon ,657188249,77336078,6802,2004,734533133,2022-11-30
f58e1bc9762abcb9,at&t,568757984,52309480,6982,1662,621076108,2022-11-30
0e078bc457288418,at&t,635068407,52069212,0,0,687137619,2022-11-30
82346222dbddb454,t-mobile,605823318,44573198,784115,80588,651261219,2022-11-30
14027b4d1297db0e,,869168015,45502763,592557,152837,915416172,2022-11-30
90aa3a47628054e2,at&t,632915818,40112311,760880,41869,673830878,2022-11-30
f2c0057735b5964c,t-mobile,967375380,56436545,1950656,275554,1026038135,2022-11-30
8a3b9c3b3111f2c4,mint,287632236,23867298,312057,30713,311842304,2022-11-30
9f904cd91f3f183c,at&t,722352911,21138387,1317511,70408,744879217,2022-11-30
09852673bad6b60a,t-mobile,969280347,61152885,6808,2001,1030442041,2022-11-30
bd8036e9dcabcdaa,mint,1290878683,90314314,703690,37421,1381934108,2022-11-30
f122942cfaccf9fe,,2376575298,42430471,0,0,2419005769,2022-11-30
c2dcbbcc9e09499f,mint,826664164,48025428,13681,2133,874705406,2022-11-30
932de8f04fd9a463,mint,239314656,35385010,1107183,169235,275976084,2022-11-30
5dda4d3c613fe093,mint,326513376,24599146,202462,72564,351387548,2022-11-30
78c8ae1128e8087e,t-mobile,585196261,87830198,29996,17593,673074048,2022-11-30
c93523a52ac28a64,,149308834,2933853,0,0,152242687,2022-11-30
317055ae9641679a,mint,295914203,5095145,1447387,106253,302562988,2022-11-30
4f31bbc63fd51e4a,,55790570,4593733,68234,31423,60483960,2022-11-30
5e0d9ffc75b18c4c,at&t,579670556,35128713,2878364,511543,618189176,2022-11-30
86a70b4da7eb4076,truconnect,4184706263,83838766,21052,12920,4268579001,2022-11-30
a5f9ed0212c95ea2,mint,515236157,58934516,840958,49182,575060813,2022-11-30
3476099b1a088112,tello,757132020,61745617,6935,2284,818886856,2022-11-30
691e37ce2c2501f7,mint,215413918,19178969,1969792,368333,236931012,2022-11-30
e9bc2628430646f8,tello,597639403,48355979,15508,256687,646267577,2022-11-30
c83fb0c65e4c1469,verizon ,897079605,64623399,128593,52427,961884024,2022-11-30
0a8b7d6dbe34f42b,verizon ,948302838,75249626,659012,22352,1024233828,2022-11-30
9d904ef178a54a1c,t-mobile,691558331,78268480,82759,27401,769936971,2022-11-30
b39fef5f1918b8e3,mint,1080153743,93729748,2045605,273291,1176202387,2022-11-30
f1d7f148f875719a,verizon ,500559043,54294532,23292374,1175763,579321712,2022-11-30
a10055213d1b050c,verizon ,390494185,24743111,6574,1637,415245507,2022-11-30
8339dcb9579fa3d4,verizon ,415743199,23100380,84067,32286,438959932,2022-11-30
4eccb73d17674a07,verizon ,1474461900,78796524,916361,93170,1554267955,2022-11-30
de769c4dce7a8fac,t-mobile,665104450,68778996,1113241,170966,735167653,2022-11-30
bc219f863d483252,at&t,831717981,49552714,749654,93648,882113997,2022-11-30
5bb9d797e28b2b32,at&t,721787425,70133239,1989401,311770,794221835,2022-11-30
d130aceda1ef6f78,mint,702935124,30242664,221279,49265,733448332,2022-11-30
8306596a965cd5c1,,172299911,3120449,0,0,175420360,2022-11-30
17bf03f6cb41e26b,mint,523203602,42868418,1384343,133259,567589622,2022-11-30
30ea6e9809925a6e,,259794824,2669472,0,0,262464296,2022-11-30
c3755ef0786bab56,mint,1469991840,30253711,0,0,1500245551,2022-11-30
26f853b70387be87,,109426626,2473345,0,0,111899971,2022-11-30
6c04fe1944972f8e,mint,6609989026,86745025,0,64,6696734115,2022-11-30
36fca4598ec218b6,t-mobile,678117318,76467946,2378347,638231,757601842,2022-11-30
0c1dd6ea41938bca,mint,3227520072,75133295,290770,17099,3302961236,2022-11-30
fc7fcc75a0988939,mint,986181079,69888702,2181173,270593,1058521547,2022-11-30
1f3aec4d49292b6c,,175354653,3097967,0,0,178452620,2022-11-30
869a145c133c397f,verizon ,407271052,38225102,2066782,304121,447867057,2022-11-30
2228c009dc90c79d,t-mobile,23953569689,396080423,1555795,464367,24351670274,2022-11-30
91902f8bbb860559,verizon ,22070143014,440841204,1239084,218950,22512442252,2022-11-30
fff1c060df61f1ec,t-mobile,637139331,54978407,688263,26806,692832807,2022-11-30
5d4b83ad922e990a,verizon ,299713159,4758095,760032,60648,305291934,2022-11-30
bf91be5843ef6d90,t-mobile,5989464739,107671936,1162792,182760,6098482227,2022-11-30
7469953664d4f7df,verizon ,952220469,71237071,893193,103517,1024454250,2022-11-30
4f6a7cdf7e615552,,14904435,420516,0,0,15324951,2022-11-30
a5acafdf90475c88,verizon ,606983839,58165618,21829249,366489,687345195,2022-11-30
e048eed4cb9c7366,,169036557,4564744,0,0,173601301,2022-11-30
b0b83a39151236e9,,177114759,6028191,0,0,183142950,2022-11-30
4d1489e91ac2bfb4,,154659919,1830162,0,0,156490081,2022-11-30
44cc1732b00b7ab6,t-mobile,18672426824,189336740,803756,143791,18862711111,2022-11-30
ec23fe88e9e58562,,178427330,2004774,0,0,180432104,2022-11-30
6ff4ef335165946d,mint,1517824356,39291141,0,4760,1557120257,2022-11-30
f783c6225ee9d82a,,154433549,2692350,0,0,157125899,2022-11-30
d019b487ff642ec2,mint,2335581249,48842916,3608,1421,2384429194,2022-11-30
f96c5fab18bb0656,mint,904356787,46152087,418,193,950509485,2022-11-30
fa780fec5e3e64e5,telcel,1214135567,24862284,713058,54757,1239765666,2022-11-30
499dcdf131c76d83,mint,667933637,25052530,7119,1830,692995116,2022-11-30
6be883858a39151e,,193406109,1753148,0,0,195159257,2022-11-30
e9d0235a1a89f5b0,at&t,571381195,44874020,1393056,99792,617748063,2022-11-30
72c64cbb9fae03d6,u.s. cellular,412643257,47008481,2090290,301625,462043653,2022-11-30
2c62eaec596e36f5,mint,725134822,40315333,1968163,281937,767700255,2022-11-30
64515e1f05c88340,pure talk,978318392,82808408,6305,1735,1061134840,2022-11-30
b542d568c5eec705,verizon ,854497124,79151293,6661,1971,933657049,2022-11-30
62eec797c6867937,t-mobile,126665743,12748432,1016164,154185,140584524,2022-11-30
19b84a32aa9589a0,at&t,897630225,81005721,1870329,246781,980753056,2022-11-30
49ff7b55aa916b66,verizon ,725382362,66516832,765917,56317,792721428,2022-11-30
9d7cd8c2fd4f971d,,1125571673,21657315,0,0,1147228988,2022-11-30
0036cd1de5f2fbee,,166176273,1539444,0,0,167715717,2022-11-30
f5b1309f66fabb21,,260027519,3770712,0,0,263798231,2022-11-30
77bc1ed952d2046d,,70539374,1230049,0,0,71769423,2022-11-30
043390745117bbba,,261240675,3673386,0,0,264914061,2022-11-30
be815ddf4f76d1c1,,183720540,3388507,0,0,187109047,2022-11-30
6fc10f0cf03cb2e4,,155267448,3004178,0,0,158271626,2022-11-30
17441842483ff345,,188343443,3557365,0,0,191900808,2022-11-30
89143a239063ed58,t-mobile,899142547,20616997,751953,65876,920577373,2022-11-30
570343f7f8c30f21,,697240232,3159280,0,0,700399512,2022-11-30
a66bb5f7f51be24b,verizon ,674311949,54492506,805529,66432,729676416,2022-11-30
c694643dbf102989,,67648396,2203784,0,0,69852180,2022-11-30
98e3cfbb2d134321,,65899932,2041141,0,0,67941073,2022-11-30
33236be6ae3d5238,,59972832,2439903,0,0,62412735,2022-11-30
c11aaae6f2c2aa17,mint,11069199732,106279884,1674895,238425,11177392936,2022-11-30
e4e4bd1b6cdff8dd,Â ,1009094403,49484584,2058062,277677,1060914726,2022-11-30
d47b3bf8616fb813,,202027829,3081677,0,0,205109506,2022-11-30
5c9487a0ce7add7c,,162737168,1838530,0,0,164575698,2022-11-30
df11645fdd6793dc,,66157382,2538439,0,0,68695821,2022-11-30
881c4f46dc9af2c2,,69441595,2564178,0,0,72005773,2022-11-30
edb677e36b5fd41a,mint,1179914260,55574642,713945,54036,1236256883,2022-11-30
d7d89cba947c59a2,,189211014,1986788,0,0,191197802,2022-11-30
7794fab989ba047c,,126622415,3213475,0,0,129835890,2022-11-30
41a058218cde7604,,70979889,2446473,0,0,73426362,2022-11-30
131dc173dd27dfc2,mint,2232724057,61057134,7044,2356,2293790591,2022-11-30
53822153169c4f1d,,157994214,2561092,0,0,160555306,2022-11-30
506cb6d295d0ac5c,,157235480,2241605,0,0,159477085,2022-11-30
95eb8d076953013f,,157128880,1641088,0,0,158769968,2022-11-30
052089716262ab70,,157838319,1467101,0,0,159305420,2022-11-30
ec95b3010a886aa8,,157568910,2194005,0,0,159762915,2022-11-30
92e21cf6ae3eb0db,,157340960,1559371,0,0,158900331,2022-11-30
bea570792230d23c,,157391758,1803904,0,0,159195662,2022-11-30
f3326a9e8f510fdf,,157254165,1450294,0,0,158704459,2022-11-30
7b922b6ba34f1e71,,157799028,2133296,0,0,159932324,2022-11-30
97d92aae6bf312b1,at&t,1020845770,19519484,670509,22493,1041058256,2022-11-30
213f8df9119b2256,,157309287,2312669,0,0,159621956,2022-11-30
78adaf0589735b03,,157316484,1256125,0,0,158572609,2022-11-30
190f3d5f141f4677,,157175113,2142830,0,0,159317943,2022-11-30
695a0b257cdf2bdd,,158001860,1673939,0,0,159675799,2022-11-30
5d86864f6f4f4087,,157244913,2143839,0,0,159388752,2022-11-30
a330d325fe364d74,,67747390,2451401,0,0,70198791,2022-11-30
368a1b0c7fdf211e,,79180457,2887905,0,0,82068362,2022-11-30
3d91661d84a33f05,at&t,2222575271,44261227,720603,73324,2267630425,2022-11-30
452238c41611fa49,,61313635,2310541,0,0,63624176,2022-11-30
890cebf01bc1813a,,71196832,2736096,0,0,73932928,2022-11-30
dd54be30096f2300,,69693787,2441061,0,0,72134848,2022-11-30
cddd04d80890ef9d,,58208630,2819502,0,0,61028132,2022-11-30
7144bebd4845edb7,,138208727,4378707,0,0,142587434,2022-11-30
d9d4fa14ad54ee3b,,185030224,4519670,0,0,189549894,2022-11-30
00b0b55b6aeb9581,,52085522,2611149,0,0,54696671,2022-11-30
a82dd293c892967b,xfinity mobile,1745182614,24333391,238022,78339,1769832366,2022-11-30
9fe207d4c6252305,t-mobile,9309343582,67555886,22222291,715992,9399837751,2022-11-30
934b28d9b6cd67f4,,1241831281,36713617,0,0,1278544898,2022-11-30
aef941e97e7690b3,t-mobile,0,0,644502018,5654609,650156627,2022-12-31
f74a7430b365a949,t-mobile,200234205,4226116,0,0,204460321,2022-12-31
102055452969904a,t-mobile,0,0,0,0,0,2022-12-31
4540a9d697479f12,,777851,227822,0,0,1005673,2022-12-31
786a9f59be5bcaf2,,48145375,14829946,0,0,62975321,2022-12-31
a6b124230da49673,t-mobile,0,0,0,0,0,2022-12-31
22a0b810804657d9,verizon ,0,0,0,0,0,2022-12-31
db6e21dd6d0e1f87,,719365234,16613509,0,0,735978743,2022-12-31
9f29a370a7e39946,,12459648061,263181839,727242,126409,12723683551,2022-12-31
a7ca4bf5e808c3ac,,199489011,5076378,0,0,204565389,2022-11-30
d8d808a7cf8d26d5,cricket,837764,240260,13119,20830,1111973,2022-11-30
0f138d90d147b091,,226243006,16631841,0,0,242874847,2022-11-30
b6279d7caef4a434,at&t,0,0,0,0,0,2022-11-30
1482fa922ade7875,,979771001,29406534,0,0,1009177535,2022-11-30
84e1c26be056ab6a,t-mobile,0,0,0,0,0,2022-11-30
1cbf17ee9bf613ff,t-mobile,0,0,0,0,0,2022-11-30
80630c1258eb8f01,,8226,1970,20982,8133,39311,2022-11-30
b7b7f9eb832d11c1,verizon ,772721024,88712543,809548,77280,862320395,2022-11-30
9434241933bc8b48,,1153241125,71450813,1241038,838860,1226771836,2022-11-30
d7dd3c41097e4af8,t-mobile,1016648093,77036988,8137,2117,1093695335,2022-11-30
81879b24e66f9ed2,home,36143,10859,0,0,47002,2022-11-30
b62294c10dfc9306,t-mobile,29759,9298,0,0,39057,2022-11-30
5b8e7e1cc93e9606,t-mobile,299696293,5971666,0,104,305668063,2022-11-30
62fb3608dc5a0ed7,t-mobile,245120292,20370403,14657,5629,265510981,2022-11-30
fcad44b3f812ee6e,,538741,180726,0,0,719467,2022-11-30
b65cdb0e140a3b1a,t-mobile,2500689814,43663341,11434,3737,2544368326,2022-11-30
d09d0fb6fd3ec1aa,verizon ,69228600,1592164,179360,60694,71060818,2022-11-30
a31ff16abd9412d1,,2334331173,67414227,0,0,2401745400,2022-11-30
6d5da0d1f173a512,t-mobile,762275897,68150588,137107,50207,830613799,2022-11-30
be7ed1874c65e92f,,877784,358707,729430,308288,2274209,2022-11-30
813e1eb117a1b50c,t-mobile,0,0,1422525,94622,1517147,2022-11-30
bbf0dfcff89c68aa,,1676708348,30515875,0,0,1707224223,2022-11-30
c9c335dd77f99434,t-mobile,703266537,29234122,805,5722,732507186,2022-11-30
8222e27ca383b818,verizon ,603142889,78553098,78036,34662,681808685,2022-11-30
8e51b6010d66a0b5,t-mobile,0,0,380001,111522,491523,2022-11-30
41b7589741c04448,,57374761,2990962,0,0,60365723,2022-11-30
158a87757afd53c6,t-mobile,702255,185273,129825,39591,1056944,2022-11-30
c5e280c00219d01d,,480469,143832,0,0,624301,2022-11-30
e494db982e954d0a,at&t,44229,192430,0,0,236659,2022-11-30
2b8f9a036d9f0bbf,,1299716548,21628903,0,0,1321345451,2022-11-30
f4620269c9ccfc0d,,726171,407201,307454,118985,1559811,2022-11-30
cf742c97c9f7ecbb,,892453391,63752712,13897,4483,956224483,2022-11-30
be7929447cf8b6e4,verizon ,0,0,433384000,6297164,439681164,2022-11-30
28d647074ffb5623,,2589201068,46057694,0,0,2635258762,2022-11-30
1b9aabea1aabb85b,t-mobile,858458591,53050591,258913,97340,911865435,2022-11-30
f458b190e9a9fd1a,t-mobile,720253,193197,154229,49388,1117067,2022-11-30
888d47d65bcbe355,,4651545,126713,136784343,1780728,143343329,2022-11-30
faddae6d194ad2cc,,709440,239890,183699,68785,1201814,2022-11-30
fe7941716f448048,t-mobile,131238075,3557523,39308,797333,135632239,2022-11-30
b8b12c21e55b7460,,33376,6976,0,0,40352,2022-11-30
c017666912878955,,0,0,895023,298865,1193888,2022-11-30
26b53be967b97282,,503743,149799,284999,105271,1043812,2022-11-30
812c232708e8fd2e,t-mobile,928600,400045,573343,247665,2149653,2022-11-30
fbc995f4f998529d,,995023,415884,0,0,1410907,2022-11-30
213b1de9dd85c822,mint,621025055,53603820,12176,2435,674643486,2022-11-30
cd833e8be3382990,,2307454219,64942692,1015833,206349,2373619093,2022-11-30
41b9fd8448a5dd9a,at&t,790304,294344,284898,112595,1482141,2022-11-30
850a778a4b3a2b83,,836623,253160,0,0,1089783,2022-11-30
05c1a23b77008fae,t-mobile,748360257,12490936,4280,166300,761021773,2022-11-30
5a44098e95aac0c1,t-mobile,800308449,7279257,15040,143861,807746607,2022-11-30
b207e8e59ead986b,cricket,15955196676,349626235,42228211,2036121,16349087243,2022-11-30
9b7edcd04255ed50,,22647,9884,0,0,32531,2022-11-30
3f3a05f99839dada,,122352238,1921005,0,0,124273243,2022-11-30
9a04a4c33955214d,verizon ,864343873,88530052,0,0,952873925,2022-11-30
f952ced44b1517b5,at&t,3369963486,84548483,316146,128869,3454956984,2022-11-30
426a0ce4a8256359,at&t,288045,116922,69441,40015,514423,2022-11-30
9b377384282ec737,,156451907,27023817,8700,3214,183487638,2022-11-30
229eb7780457c4cc,at&t,0,0,0,0,0,2022-11-30
631b48a92c4dd934,t-mobile,79242,135074,218,2590,217124,2022-11-30
b316859b538051d1,,1014478,194402,0,0,1208880,2022-11-30
bd2dcf5bef4c5226,home,726190211,53946553,24280,13299,780174343,2022-11-30
a4bc8be786b8d970,at&t,142060,55681,0,0,197741,2022-11-30
9a9287ea56cc8b81,t-mobile,658409781,20320616,27833,9278,678767508,2022-11-30
a5dd6b50701c014d,ting,257659717,22008252,838397,143496,280649862,2022-11-30
cfb7d444513bb633,verizon ,24789610602,421500216,684120,25891,25211820829,2022-11-30
26aac3df2eddefb3,verizon ,28743,196169,0,0,224912,2022-11-30
5296e493a69f7d0b,verizon ,6540095301,141979740,2007395,311840,6684394276,2022-11-30
2a1e2d699c2299c0,t-mobile,732164,237060,378750,139560,1487534,2022-11-30
7d11ad82c37deab6,verizon ,986197,263904,322197,195985,1768283,2022-11-30
471263f43dde69e5,verizon ,570128478,59835982,1236678,205864,631407002,2022-11-30
42f85129ed409760,,856690,287243,0,0,1143933,2022-11-30
96903d92fce9a1ad,ting,388732222,30065324,11770,4258,418813574,2022-11-30
193f8c7ae4c325ee,mint,200689447,3321480,1866,22836,204035629,2022-11-30
4621365aff7a4604,,273539,80720,871528,377450,1603237,2022-11-30
7596ee8676b9a370,t-mobile,1138935096,65046056,43931,16284,1204041367,2022-11-30
ca59e2d08f93a554,,763993,267453,127742,39014,1198202,2022-11-30
052f698fbb184011,mint,395378,134496,47793798,1159723,49483395,2022-11-30
715297ec198d8de6,mint,301444,81776,0,0,383220,2022-11-30
d24ff2cfaf262000,verizon ,394923188,48566818,1113202,184607,444787815,2022-11-30
57397050bbe5f70e,mint,613068,350562,30665,10817,1005112,2022-11-30
ad00032c48a0d1cb,home,190790791,2979346,190103,168279,194128519,2022-11-30
ea15a6fff6b87058,t-mobile,730977803,82692730,43215,15337,813729085,2022-11-30
7e72a2e98dc25d7a,mint,765640,282460,92393,34192,1174685,2022-11-30
087202ac070f0f0c,,2613128621,46827017,955589,219776,2661131003,2022-11-30
0d7dae72ee6b93ea,t-mobile,160654,59865,4320263,480689,5021471,2022-11-30
ff54367c56b2df04,mint,511,1732,157819,1661978,1822040,2022-11-30
666689f55448baa4,t-mobile,363515,290224,182765,64104,900608,2022-11-30
440672d6aab42a1b,t-mobile,795783,277199,14563,4639,1092184,2022-11-30
13dc0dcd5b77da97,,62866706,2468927,0,0,65335633,2022-11-30
6af774fa1f5da74c,mint,257183,525133,0,0,782316,2022-11-30
174f68cb11cf0e47,mint,137230924,3034832,0,0,140265756,2022-11-30
e94cee1f629a4d8f,,233813118,5145597,0,0,238958715,2022-11-30
9a4d0b53b0a9be9b,t-mobile,893085,314906,0,0,1207991,2022-11-30
e735e2f3e349dee2,t-mobile,647511587,15586786,0,0,663098373,2022-11-30
db49b285ae41646d,at&t,15333,3502,0,0,18835,2022-11-30
6e82e45207450334,verizon ,675879228,43898589,21982,7913,719807712,2022-11-30
82376a5159824df4,verizon ,7812347470,131275868,709724,49275,7944382337,2022-11-30
207e52e79242fd56,mint,288873074,35243284,2180731,367448,326664537,2022-11-30
a2ef8be06c776151,t-mobile,777269652,54792990,2443358,339059,834845059,2022-11-30
b07a80b15696a33a,verizon ,206623866,3209745,244281971,4743305,458858887,2022-11-30
9275fe7466d6c192,t-mobile,553608355,53789646,1982045,334834,609714880,2022-11-30
2379093b07c0251e,t-mobile,0,0,14034,6825,20859,2022-11-30
5a741b00ea55f4f0,t-mobile,66707653,7685652,0,0,74393305,2022-11-30
dcefe41d173edef0,t-mobile,855592,241990,21696,8408,1127686,2022-11-30
2f150f7b21883e07,t-mobile,842258,288890,641934,243222,2016304,2022-11-30
687e8e029bb5f2ba,mint,816105,302871,348166,143741,1610883,2022-11-30
f3244befb6dca4b0,mint,407270917,45543476,0,0,452814393,2022-11-30
6e6f167ed075f311,t-mobile,0,0,79706,53533,133239,2022-11-30
4e67294210dc0bbc,,155437338,2766168,0,0,158203506,2022-11-30
ccd734a40f475bc9,at&t,666142,193272,0,0,859414,2022-11-30
13ad138f9cb94dd1,mint,826995,285449,0,0,1112444,2022-11-30
2141e2555b3172fb,t-mobile,796699,234199,200797,68852,1300547,2022-11-30
c87e829fda175dc7,mint,789776,268863,838073,273308,2170020,2022-11-30
6784265c8dc871f8,mint,539774402,53988573,1376119,305219,595444313,2022-11-30
4753564f6d9104f1,mint,728976606,48315486,387,978,777293457,2022-11-30
a0d847135b327453,,464821610,34837887,531785,31167,500222449,2022-11-30
bbe5b98ab5aa6f3f,,702467913,30398869,4,46,732866832,2022-11-30
c69a730eef9983a2,t-mobile,170932275,6371854,0,0,177304129,2022-11-30
f6df21f856a977bd,,541795132,62239132,36882,11632,604082778,2022-11-30
ac5124ad8faa7fff,,19833,9046,84,84,29047,2022-11-30
6300e233b80de3db,t-mobile,5019572751,128110444,102039,37215,5147822449,2022-11-30
49ad57eb8db7ce13,mint,720564277,35170328,37205,23207,755795017,2022-11-30
42426b57f3fad3a7,mint,85869,23095,0,0,108964,2022-11-30
c3d92873734ed3ae,t-mobile,757684,226632,0,0,984316,2022-11-30
78978a8bc0e7d940,mint,727770,250958,562828,238523,1780079,2022-11-30
42f73e30060036cc,,2249220757,47695109,0,0,2296915866,2022-11-30
ad35506a5f213bf9,not available,683745,240715,0,0,924460,2022-11-30
8b71bdc2badf3f2a,,154798638,2882139,0,0,157680777,2022-11-30
0838d84b45b5a48a,,382594675,5792435,0,0,388387110,2022-11-30
c2aff88f00770c75,mint,104101586,5520841,1042299,90166,110754892,2022-11-30
3ceeaa94ce3eac02,mint,755395876,49230682,82931,58615,804768104,2022-11-30
32b10f643f4fc27d,t-mobile,407278341,38487307,1996931,290102,448052681,2022-11-30
bdbdbb4e8a55b159,u.s.cellular,936598,301661,0,0,1238259,2022-11-30
432312e400ab0281,mint,2708594402,32512230,772530,266682,2742145844,2022-11-30
0aed615b547fc1ec,mint,704536,206402,160189,60439,1131566,2022-11-30
3244585597dd3b08,t-mobile,464376788,24353034,26799,16075,488772696,2022-11-30
b48ec3e723e5d9ce,,1067373440,13105557,0,0,1080478997,2022-11-30
0273d3ef8f534ac0,,198429827,27403857,0,0,225833684,2022-11-30
902c3e7a0f406696,at&t,886547,375112,271034,123252,1655945,2022-11-30
3b59eae0b845601e,mint,0,0,40212508,1802794,42015302,2022-11-30
ed0d310d7cd99863,t-mobile,796819,289730,82240,33045,1201834,2022-11-30
d23c5bff0b952b78,t-mobile,112776953,4751567,0,0,117528520,2022-11-30
2f802a7c301a4193,t-mobile,564570856,6783735,104,104,571354799,2022-11-30
0b3afcd478e67a17,,332624995,11785324,0,0,344410319,2022-11-30
e5bbb5f8bb1fdc85,at&t,734159,236421,7010,1948,979538,2022-11-30
34f5573ce45228c1,mint,133109464,7888073,0,0,140997537,2022-11-30
c8ee1b2d03a257eb,red pocket,520458493,51898972,1135114,211666,573704245,2022-11-30
68c6dde170a88c4a,t-mobile,99188355,1737630,81557,865982,101873524,2022-11-30
e04d97c89e0c85b6,,880322,388905,7599,2117,1278943,2022-11-30
762dcbe91555e18d,,1232556383,35824087,1266060,221575,1269868105,2022-11-30
540e3fb95b144ed3,mint,1274367,547319,0,0,1821686,2022-11-30
7a3fac8dfc168a3a,t-mobile,176905393,2582464,111051,37440,179636348,2022-11-30
388146f691a536db,,50738494,1368620,0,0,52107114,2022-11-30
39c7b4b7aea53478,,957861048,65383652,1345092,307121,1024896913,2022-11-30
0dcefb5c5de94ba4,mint,641450413,71031307,6248,1397,712489365,2022-11-30
56ab88d969b13ba7,,81722235,1675983,0,0,83398218,2022-11-30
893935797cd558f8,mint,0,0,666758,113895,780653,2022-11-30
fe2433b794930506,mint,662223018,44263165,104,104,706486391,2022-11-30
ba84719c15fbb7e8,t-mobile,73521178,1904829,0,0,75426007,2022-11-30
69e1a6e5cdddef12,mint,599513624,6960870,8884,142474,606625852,2022-11-30
6d65a192d8044ec5,mint,15059,3398,25741,9627,53825,2022-11-30
252aabbff6fe4813,,31756,8087,0,0,39843,2022-11-30
ef9c08f6306bd910,mint,328500870,6120052,0,0,334620922,2022-11-30
a5929368d3feb7fc,mint,1261155015,45815413,18337,120338,1307109103,2022-11-30
3ba882e57ed0d99c,,401365087,40419889,1893435,339502,444017913,2022-11-30
190e2b5ab6e016a0,t-mobile,786451244,69286678,840241,93726,856671889,2022-11-30
b2b0c7c97af4a437,mint,43625359,914808,533405,21536,45095108,2022-11-30
a9a3776fb7df122b,,8074025,1186695,0,0,9260720,2022-11-30
481d7c49aed5cbda,t-mobile,527168261,44388374,4465846,451434,576473915,2022-11-30
868e68cdc3df12be,,872607,248090,178545,58850,1358092,2022-11-30
240bea290b197656,t-mobile,3452452427,134509106,960574,136611,3588058718,2022-11-30
e461e7b5707a339b,,73597150,1495675,0,0,75092825,2022-11-30
a5584b4c4323a5a9,t-mobile,1434997694,30034961,6553,1294,1465040502,2022-11-30
b7bf866b67c7c271,t-mobile,871885,274271,501155,155890,1803201,2022-11-30
997df8799b56728a,,354999762,4194959,0,0,359194721,2022-11-30
f37cee963408e51c,,32524795,1268879,407580,20531,34221785,2022-11-30
ccf9e931ced27f02,,6517728490,146519937,16391,7107,6664271925,2022-11-30
e63f9e7c4f724eb0,mint,713987831,36808790,93373,35950,750925944,2022-11-30
cad03c3fb3a076bf,mint,143568387,5055134,3421,2936,148629878,2022-11-30
06c627246f835842,at&t,1323562,219314,0,0,1542876,2022-11-30
9b998b53056f7c0a,mint,6085463,388687,180,1862,6476192,2022-11-30
fcc48f7afaef6d74,,798101,227198,0,0,1025299,2022-11-30
ff5f23a75084307b,mint,345671,87166,6128,1799,440764,2022-11-30
1265ae8b3f1d9e9b,mint,162664961,16398812,133101,54774,179251648,2022-11-30
6e9923963d9d1ef6,q link wireless,144865551,2355420,0,0,147220971,2022-11-30
839d9d5ab31b6a1a,t-mobile,653962035,77101787,846054,98037,732007913,2022-11-30
5e8b87469fee6acf,mint,616812522,65620112,713425,58102,683204161,2022-11-30
36ca6f96977d4ad6,mint,510751810,23331188,769,1699,534085466,2022-11-30
9e37bfda31d28913,,73503341,1557630,0,0,75060971,2022-11-30
1d24fe01dd57057c,mint,602524915,49311443,6684,2033,651845075,2022-11-30
fd053228be8ee406,mint,832388892,62025447,32510,15615,894462464,2022-11-30
0f54508a030f6822,mint,616790872,64390631,0,0,681181503,2022-11-30
e688709a149dfd0a,mint,446762594,39803209,213691,86490,486865984,2022-11-30
67beba0f54cdb769,mint,800205561,72603806,13726,4496,872827589,2022-11-30
22c29224841b8df7,mint,812252,250605,141281,45938,1250076,2022-11-30
fab6b3ec4e55010b,mint,939937796,62438893,533040,27459,1002937188,2022-11-30
38e9e93e36a5cd5a,,697310940,64476422,0,0,761787362,2022-11-30
cf64b60aae76f0a0,ting,572621943,70511566,107077,35891,643276477,2022-11-30
d56dc9d1a32ccb9d,mint,1129164150,82200688,1384,3232,1211369454,2022-11-30
5ee5bccd6d6d9cc5,mint,906424,241280,38679,11222,1197605,2022-11-30
8a9a50a9f63d8dcd,mint,960501,312741,865442,707389,2846073,2022-11-30
a8acbfd695e86e14,t-mobile,891503159,55739826,14512,5332,947262829,2022-11-30
68c0e5ff08676c47,mint,487690874,28437488,6972,2284,516137618,2022-11-30
b2aa2d6582dbd3f3,,31735446,1460214,0,0,33195660,2022-11-30
a014bf45efade6d6,verizon ,849388650,77586263,61055,19147,927055115,2022-11-30
1d4a8fd5b23cab1c,verizon ,294512264,18214989,2041289,291081,315059623,2022-11-30
18aa5ae4aa073489,mint,1727046313,96205778,6879,1827,1823260797,2022-11-30
f0100b3c8529c126,verizon ,1036928260,90453682,2323869,1173861,1130879672,2022-11-30
68ebcda2c6352c00,verizon ,545999,147644,534442,162740,1390825,2022-11-30
f8fc56a018f626b1,verizon ,937584992,65356828,37094,17357,1002996271,2022-11-30
c9b13f362c2f3814,at&t,107551472,16734926,24612,22805,124333815,2022-11-30
7ba781642cdad9f9,verizon ,527463982,70782047,2489,565,598249083,2022-11-30
dd732135b10e91dd,t-mobile,281633388,13872747,2058438,444643,298009216,2022-10-31
3e409e84fee04970,t-mobile,0,0,0,0,0,2022-10-31
a4c2933c35b83d4c,t-mobile,33981426,5667198,0,0,39648624,2022-10-31
9013b126f2b16286,,780107,210214,0,0,990321,2022-10-31
843b70b00572faea,,1457392,240501,723004,127074,2547971,2022-10-31
5a6d100179a32aff,t-mobile,839676,289633,363654,467751,1960714,2022-10-31
2eead77e370463be,,149357579,2771329,0,0,152128908,2022-10-31
deab01a762937827,,8302331,1436515,0,0,9738846,2022-10-31
97c2ecf8ff98bd42,verizon ,7031562848,170203893,0,0,7201766741,2022-10-31
af199e8c44fe1d71,t-mobile,0,0,0,0,0,2022-10-31
8f42ab0bed19f2de,at&t,0,0,0,0,0,2022-10-31
07d51440257ac0fd,t-mobile,2476891089,119347717,6972,2284,2596248062,2022-10-31
f170ede00488370a,verizon ,0,0,905389,377438,1282827,2022-10-31
3387f8cd9936f8ee,t-mobile,866123,270644,499980,179575,1816322,2022-10-31
7c27aaa568f63bbf,home,258668823,5100226,0,0,263769049,2022-10-31
e55b1597f1c74b40,verizon,0,0,0,0,0,2022-10-31
c82081141e23c0b5,t-mobile,3156209470,103653788,66103,19960,3259949321,2022-10-31
3791dd60c8cdf860,,405158790,7401016,0,0,412559806,2022-10-31
f19e40f4bec5079e,t-mobile,1596709168,26165207,704,6927,1622882006,2022-10-31
cdd4694ac9de0a03,,883272,296124,0,656,1180052,2022-10-31
a5cb8c62bb85235b,t-mobile,626246,157265,459668,113167,1356346,2022-10-31
b045e8e2629408f0,,285995875,33898250,0,0,319894125,2022-10-31
36152744a8d0ab70,t-mobile,845693,304459,0,0,1150152,2022-10-31
a407d1f417bfe1d0,t-mobile,0,0,70388,975466,1045854,2022-10-31
e8df73fcfcdc90d3,mint,2789599609,105886521,504398,136896,2896127424,2022-10-31
93cdebe1ca8ba0bb,t-mobile,90826249,3109760,467691,180896,94584596,2022-10-31
b8078a5614b70498,,878852,283160,83027,29406,1274445,2022-10-31
3dc9e34f06ffce94,verizon,0,0,0,0,0,2022-10-31
273288faf0d71056,,934579117,72598256,61566,20128,1007259067,2022-10-31
9ad9cf095f368329,ting,0,0,0,0,0,2022-10-31
3fcfebd9f74a89f2,,2795088603,45227624,0,0,2840316227,2022-10-31
7030fccbb60823fd,t-mobile,2938340092,84814288,1333173,117922,3024605475,2022-10-31
a7479ac223535043,t-mobile,0,0,0,0,0,2022-10-31
8149ab14fa988f59,verizon ,27910645260,479558656,90226521,2915979,28483346416,2022-10-31
7afb46850e006ad3,mint,830119504,60039383,0,0,890158887,2022-10-31
27fb6b04a0b0f79b,,96926632,2489011,0,0,99415643,2022-10-31
adad1ecb27459b38,home,662936,699290,414228,176976,1953430,2022-10-31
7d683d128e8356e4,mint,596441235,37566073,32341,19808,634059457,2022-10-31
6eeff0347dcfe041,,84,84,0,0,168,2022-10-31
68a784fb3b5c2f50,t-mobile,3213,4085,2002456,342581,2352335,2022-10-31
ce465b64705e9a39,t-mobile,0,0,0,0,0,2022-10-31
7da93070f35da976,t-mobile,619979938,62335465,6972,2356,682324731,2022-10-31
c1fd30348e2344cf,at&t,0,0,736631,197634,934265,2022-10-31
66b3c0aa55820a34,,696492857,44136663,1144437,239273,742013230,2022-10-31
54c94dab3f027c64,verizon ,20745,7162,901589,483444,1412940,2022-10-31
521352127aa3e270,verizon ,0,0,315135,460701,775836,2022-10-31
eac72ba99b11d029,at&t,854822,264945,0,0,1119767,2022-10-31
0baf8a4adb5bd108,at&t,1317870710,125571353,730200,50897,1444223160,2022-10-31
11d19e6aef8df7c3,mint,0,0,0,0,0,2022-10-31
ce79dff0b5aadaca,t-mobile,95365705,3480195,14126,4997,98865023,2022-10-31
e086ce8cd15d2c79,t-mobile,67063339,2365836,113559286,1412381,184400842,2022-10-31
e17c4a5c72572fd2,t-mobile,140292541,1751423,20667870,2718866,165430700,2022-10-31
83bcf2593a28b59e,mint,0,0,652671,289114,941785,2022-10-31
e0db74e5e36dea55,t-mobile,692304,260292,345369,256334,1554299,2022-10-31
ceb8446edfce4e24,mint,46362,132087,70494262,1302011,71974722,2022-10-31
11be0c32d51bea1e,t-mobile,1223891999,56351727,8295,3320,1280255341,2022-10-31
8184be3964219b0f,,843778,259046,111554,37025,1251403,2022-10-31
49f77a4b9f5b17ab,,456062,327976,0,0,784038,2022-10-31
2067970c32928bbf,verizon ,351704674,36223246,1407836,286483,389622239,2022-10-31
e75ccc4944af3168,verizon ,189769639,19880702,923382,156855,210730578,2022-10-31
7f5c964006f2b6ea,,509697055,7856963,0,0,517554018,2022-10-31
fb96d7180899a005,verizon ,2593460489,98379592,229279,91157,2692160517,2022-10-31
e3176bcd91ebc04c,,1637866390,25636189,0,0,1663502579,2022-10-31
80f8ae5f75cf2e53,mint,1099667454,64220571,0,0,1163888025,2022-10-31
3ad1d76ecab0719e,mint,707716292,50874337,736469,69098,759396196,2022-10-31
1e250e0bd961b13c,mint,798375879,98956451,0,0,897332330,2022-10-31
c201c984bf2ba7d8,smart,44966324,1987751,0,0,46954075,2022-10-31
288d711eb6cebe21,mint,2791311574,82875204,118554,42242,2874347574,2022-10-31
431ee4b10f39d2de,home,56273,491515,68750,530269,1146807,2022-10-31
f3245a3de1b2b582,t-mobile,651352,356709,3045,908,1012014,2022-10-31
08d64db68302b9f2,mint,612096154,53185640,7465,2291,665291550,2022-10-31
0411a095a463e1b6,verizon ,481797483,14125629,132203735,2719338,630846185,2022-10-31
c9e935fcdf94e96b,,137941064,1434252,0,0,139375316,2022-10-31
69c401503a9b9aab,,51375,44773,0,0,96148,2022-10-31
090b84fede8d2d9a,mint,841854753,80725352,676115,41772,923297992,2022-10-31
1acaf2c4c5c16108,verizon ,919887,258269,875110,326200,2379466,2022-10-31
0baef35ab708a852,verizon ,202054153,14573147,1964,14195,216643459,2022-10-31
6f438d700537fc9a,t-mobile,465001075,6180388,129956406,2488489,603626358,2022-10-31
edd69ad82e893667,at&t,555993,341717,52341,22927,972978,2022-10-31
63021887236453f5,t-mobile,40600,115679,0,0,156279,2022-10-31
88b62c864b04a9ae,mint,33210707,4747183,977705,182936,39118531,2022-10-31
52d1fd221dc92eba,verizon ,715084,194296,33329,9701,952410,2022-10-31
ba41ca4ccaf82501,t-mobile,266397,59892,0,0,326289,2022-10-31
73c0270f145fcf9e,mint,159851201,2434391,54866556,1429862,218582010,2022-10-31
446450a7af2d5cc9,t-mobile,691791323,63175954,163998,66655,755197930,2022-10-31
fb080e93750f99d7,verizon ,366149896,51105890,665318,37577,417958681,2022-10-31
ec1a9fdb07f37b57,mint,795760313,96154830,4,4,891915151,2022-10-31
ae0ff9f064ad4e8e,robi,3439117,533097,0,0,3972214,2022-10-31
f35bc61ad9ed5bb2,verizon ,263867056,9147652,2002312,324514,275341534,2022-10-31
34cca56a707c6a39,,331937,101296,759911,270093,1463237,2022-10-31
702692efb103f1b1,t-mobile,1748449775,80207745,609044,12859,1829279423,2022-10-31
9681f5cc25993b64,mint,654658457,8536670,698116,204331,664097574,2022-10-31
fe03b1d83dc7bd50,,2148521800,102562270,14856,3243,2251102169,2022-10-31
d64e76322da895fc,mint,271844420,4300587,56064522,1515817,333725346,2022-10-31
031b65742d6d04d3,mint,731221,263027,378148,443019,1815415,2022-10-31
927f3ecdb17d8c7d,mint,204504157,12775686,0,0,217279843,2022-10-31
009801f524b6664b,mint,119263912,7423581,33511,8154,126729158,2022-10-31
44ae76445fbff091,t-mobile,849868,254833,229370,57177,1391248,2022-10-31
f9289fdd2a8fa1b6,mint,42774,132654,692,2264,178384,2022-10-31
8a4bed8eb960401b,mint,65768812,8301636,22086742,796116,96953306,2022-10-31
ff29b5d1c488b2e4,t-mobile,1098412403,42564148,911873,116729,1142005153,2022-11-30
92da1f6be521efa6,t-mobile,212556158,10124894,15220,3949,222700221,2022-11-30
283a33b768b2873c,mint,315454653,31560019,16110,202932,347233714,2022-11-30
30cf9a487f166fc2,ultra,5408536,630793,0,0,6039329,2022-11-30
0bdd1cfb133e882e,mint,162211378,2400019,0,0,164611397,2022-11-30
c6709c5964eb4ff1,t-mobile,15355376040,268816228,0,0,15624192268,2022-11-30
896f2c28342cb263,mint,677326508,26121716,88651,31612,703568487,2022-11-30
357d556e9ce9a7c2,mint,7982384385,175963591,1424552,89443,8159861971,2022-11-30
479afdfc8955de7c,mint,920125607,44803875,831676,97879,965859037,2022-11-30
cd1767f562cde09a,mint,0,60360,113747,148990,323097,2022-11-30
f84fb9870a3944ab,mint,31364965,2064742,0,0,33429707,2022-11-30
5dc81c2cec2e8e90,mint,399737977,23774496,28362,9478,423550313,2022-11-30
5c47a5a60618ead4,mint,658578875,46276380,0,0,704855255,2022-11-30
bcbaa5b693ecb6dd,,84,84,0,0,168,2022-11-30
7ca5dae943467945,,351231147,37005047,920,1509,388238623,2022-11-30
0cf189c0284b1762,mint,567941811,46463486,84,84,614405465,2022-11-30
f8c560fffa5edd9d,mint,75124881,1713386,0,0,76838267,2022-11-30
db46ba1d585cce88,t-mobile,1000785724,18820593,0,0,1019606317,2022-11-30
f949754765cb2028,t-mobile,579470810,51142368,14439,2507,630630124,2022-11-30
ce9779c6bac8ac3f,,188793003,4194833,0,0,192987836,2022-11-30
bd74412cc1a32311,at&t,702004672,75902288,7518,1840,777916318,2022-11-30
f5f39ebb4d7396e3,t-mobile,0,0,1935032,66891,2001923,2022-11-30
d008831bf248125a,verizon ,610801932,70454259,1498378,110662,682865231,2022-11-30
a9bae934c2984120,at&t,265693209,7205904,23609,8689,272931411,2022-11-30
91ac2f2beec42e09,verizon ,650266875,29566355,38470,18757,679890457,2022-11-30
c6d2212bd9518d50,verizon ,176501,240115,18207,405741,840564,2022-11-30
cc6754783995aa30,verizon ,293084624,39751280,2043242,272895,335152041,2022-11-30
5453fab2a72538e5,verizon ,590155465,64288408,27122,7521,654478516,2022-11-30
3ce08e6524836bbc,t-mobile,929969963,29621119,297295,82615,959970992,2022-11-30
75dd11160745f159,at&t,0,0,1776939,239955,2016894,2022-11-30
86c2c0c7d3a4d830,,2069009,155551,949268,548059,3721887,2022-11-30
2eb5f2613b2121a1,at&t,383081744,36669029,882836,119091,420752700,2022-11-30
3f0351c52e9773ae,t-mobile,670499054,77537635,1077617,200068,749314374,2022-11-30
ffe37be18e9ec46e,at&t,1025922587,61970606,710282,73615,1088677090,2022-11-30
54e6a5d657ae61ad,t-mobile,5521081700,51232755,7471,5533,5572327459,2022-11-30
5af3cab09afee616,verizon ,879816489,71762002,0,0,951578491,2022-11-30
613674d1ba127d9c,verizon ,148891037,2357436,44926640,2330850,198505963,2022-11-30
6f0b80cf4c50141d,,5559473850,138107644,0,0,5697581494,2022-11-30
3893d0311cf82fe9,at&t,223895,85104,223476,97532,630007,2022-11-30
bd2a0abaa12b817a,,1091654946,12749165,0,0,1104404111,2022-11-30
f1695574efe3bcab,verizon ,283988586,27821189,1111433,218755,313139963,2022-11-30
2d74d0c672fc182c,verizon ,1261941725,77369481,768044,63353,1340142603,2022-11-30
58cbcc3eb3788313,Â ,0,0,979748,67712,1047460,2022-11-30
26b8a2699a95234a,verizon ,1272742273,64696671,846261,67091,1338352296,2022-11-30
9572706f78bd7f30,t-mobile,5037956171,121569552,602810,180296,5160308829,2022-11-30
a9cbdaf3ff44048c,at&t,543736578,63896063,1100148,170106,608902895,2022-11-30
f7891df2ba625f25,verizon ,998677076,56784551,190414,72265,1055724306,2022-11-30
0d153dc7ffe5bfd5,verizon ,515945211,48286526,20714,6043,564258494,2022-11-30
059db337fbec80d3,,12103033,146785,0,0,12249818,2022-11-30
9eadf081ffbccc61,metro by t-mobile,541973168,84049418,7128,2391,626032105,2022-11-30
3d127d738b195a71,mint,0,0,1267534,235053,1502587,2022-11-30
c5a0b489bd4f5cb7,,183230609,3475582,0,0,186706191,2022-11-30
27ae0db4a30a000a,mint,703128933,77242847,11254,1645,780384679,2022-11-30
1d74eb8f3a6de3ce,mint,378122590,17685290,0,0,395807880,2022-11-30
0d9c0d60fffa073d,t-mobile,25673,52585,0,0,78258,2022-11-30
22c40c530c71e6e5,,160999,269517,0,0,430516,2022-11-30
27995522164a86dc,t-mobile,54417899,2766946,482044,368269,58035158,2022-11-30
dce5d7916e6c6375,mint,547026806,12653581,144588,54967,559879942,2022-11-30
d8dde1ab610d1377,mint,677327476,53894090,825053,85842,732132461,2022-11-30
42609361f3379383,t-mobile,1050406,222301,1256479,335964,2865150,2022-11-30
80c2dc5ba69c7ab3,mint,3244,10522,37430,11434,62630,2022-11-30
573d5a56eabd85be,t-mobile,74413934,1769620,104,189,76183847,2022-11-30
7a5a60ce8018a44f,mint,548553,164952,44950,16583,775038,2022-11-30
71d244c44b7f8eba,mint,262096246,6260250,231,1884,268358611,2022-11-30
e5873a79501d3406,t-mobile,4139441627,126269865,1855669,264074,4267831235,2022-11-30
a79aed7a02d4ba7a,mint,839327796,80195840,1914552,293353,921731541,2022-11-30
a06c2f957548fe8d,mint,790905,214962,12206,131074,1149147,2022-11-30
69467a2e63c901ec,mint,4442566682,98430724,20599420,643815,4562240641,2022-11-30
6abf0134aee33383,verizon ,746376793,45713518,707077,41961,792839349,2022-11-30
a4b61ab6730f6a35,mint,277393663,18049955,1131949,170506,296746073,2022-11-30
951025477b5ba27e,verizon ,283330469,13579424,1373702,57835,298341430,2022-11-30
64b1dfbbf82d3252,u.s. cellular,1502823860,77672606,1612655,84452,1582193573,2022-11-30
4e3fb45a2a863fac,verizon ,455187203,9227240,727715,56473,465198631,2022-11-30
28bbcd434c28c6b6,verizon ,36945,8928,0,0,45873,2022-11-30
62b9aa2d9e94712e,,29726,7540,0,0,37266,2022-11-30
98e5c4d002fc3790,verizon ,2577583036,67509041,683966,43561,2645819604,2022-11-30
96dd130c0d0f038d,verizon ,670897661,28781030,0,84,699678775,2022-11-30
b80a753e553d2edd,mint,644626586,65677430,6621,1753,710312390,2022-11-30
2d4ead3597a93778,at&t,350838973,25119790,157837,59125,376175725,2022-11-30
e867ac4c29ef221f,verizon ,599425667,38990817,235599,81990,638734073,2022-11-30
90ec5e411b418cfc,verizon ,829718912,79665818,806395,69759,910260884,2022-11-30
943ad206b3f10dfc,verizon ,1770193951,99110000,90864,26878,1869421693,2022-11-30
dde5ad1809415ab6,at&t,818052561,57960766,37680,23685,876074692,2022-11-30
0d0a529880bfbbc3,verizon ,985185772,63372375,1913954,272557,1050744658,2022-11-30
f05fb197d49d5063,verizon ,0,0,1265190,242397,1507587,2022-11-30
fb0b4880d5633cf0,,147585715,1302017,0,0,148887732,2022-11-30
6b2c1be40501b6d1,at&t,0,0,1951813,505090,2456903,2022-11-30
020433d00f368a38,verizon ,961678290,54373168,2709,2691,1016056858,2022-11-30
1109b7dd7dd23f62,red pocket,1602089017,13858488,20091398,962108,1637001011,2022-11-30
90733371d0b3430a,at&t,513567636,55590553,2182707,346878,571687774,2022-11-30
e02b19f4856546e1,verizon ,288800615,20691668,1400036,68685,310961004,2022-11-30
978f601fcee3aaec,at&t,1150960808,47476502,24023,13728,1198475061,2022-11-30
92d4755c737efa09,mint,417,1922,1396075,74582,1472996,2022-11-30
2417daf089c88008,verizon ,584872479,60358449,21204135,589718,667024781,2022-11-30
beee602afff350ff,,898973714,5642614,0,0,904616328,2022-11-30
29777f6a65635e49,mint,1095417437,91180264,686313,27182,1187311196,2022-11-30
87291fb68a5924c0,verizon ,3921686230,103413572,1371928,108835,4026580565,2022-11-30
74d30aa955b352de,mint,614711199,63006652,104,104,677718059,2022-11-30
a6620a91c6013572,,20313423,421853,0,0,20735276,2022-11-30
1243f87db4f7c99c,t-mobile,439487691,39948656,164833,60500,479661680,2022-11-30
af734dad0041b02a,mint,643786140,61315950,80240,4448,705186778,2022-11-30
38883d833d37ef82,mint,550617816,37836437,1820269,203115,590477637,2022-11-30
c397e92db944b885,mint,605095034,51976383,13883,3981,657089281,2022-11-30
fa34b3dd0626975a,mint,30511700345,173367162,14648,5766,30685087921,2022-11-30
3cef5a631e86614c,metro by t-mobile,567867482,75337172,121924,44726,643371304,2022-11-30
cb565362fb8a1aa6,t-mobile,484106081,27662411,819133,45580,512633205,2022-11-30
ca3649aa91515201,,1580592015,33250899,0,0,1613842914,2022-11-30
c4970e55abc42c8d,mint,413701165,11174965,28985,10743,424915858,2022-11-30
1a846df0bb72eb9c,mint,611672137,14085413,676416,57898,626491864,2022-11-30
cdb3840e57c216ea,t-mobile,359628635,8229006,1405742,106570,369369953,2022-11-30
48469d8b0adc329b,,511838548,53734978,0,0,565573526,2022-11-30
db1251cb51f0ffc2,mint,259052723,32825134,578,4863,291883298,2022-11-30
5dff5266ba65530e,t-mobile,481454779,8093251,1943562,236945,491728537,2022-11-30
4719d094679f232b,t-mobile,286908316,25497469,800982,50239,313257006,2022-11-30
46291d5561257ac7,mint,558861569,55235047,1524532,100228,615721376,2022-11-30
a1cc6b13d7470dfe,mint,17208258,539622,1033549,338397,19119826,2022-11-30
eede73b040f947db,mint,0,0,624894,77169,702063,2022-11-30
bfd0f75f3f481851,mint,389599,103633,557777,172830,1223839,2022-11-30
95cddcbf10ea6085,t-mobile,687321593,7973144,0,0,695294737,2022-11-30
635e4c4189196054,t-mobile,670938821,24925078,163415,63222,696090536,2022-11-30
e78204fe4c608ade,,45341,136315,0,0,181656,2022-11-30
b084a4f52fc3a4d1,mint,814298583,30012471,21640490,458691,866410235,2022-11-30
a338967d8040afad,home,957748465,70539130,0,0,1028287595,2022-11-30
dc0eaaec0ed45512,,35282,7341,0,0,42623,2022-11-30
6e241757a94061a5,metro by t-mobile,444852035,41440993,15082462,1119898,502495388,2022-11-30
53dd61b1b1064f65,at&t,829491,233032,206,4726,1067455,2022-11-30
05291d51f78cb013,,31444682705,451329940,620551,174140,31896807336,2022-11-30
3e1e5a092a96b8ff,,218482,184112,7599,2189,412382,2022-11-30
9180dcdf4eea3992,,21126138102,263661943,6700,2335,21389809080,2022-11-30
316b106d65c87061,t-mobile,168420401,12559926,20333,5940,181006600,2022-11-30
32121ee1c1277823,mint,282674806,7284229,0,0,289959035,2022-11-30
4af3756223963827,mint,729213261,62036220,498,911,791250890,2022-11-30
cba44366638b2ed5,mint,1263176,244448,635190,114953,2257767,2022-11-30
f68bbede92cda0b8,mint,290885451,9080459,0,0,299965910,2022-11-30
9b5713a12bffa4dd,home,0,0,456774,27021,483795,2022-11-30
96502769bc4c4eac,t-mobile,745826038,87724875,2882172,1161882,837594967,2022-11-30
733281e33365ea78,,147969989,2373824,0,0,150343813,2022-11-30
a8278fcdc47ff4bb,mint,0,0,903330,272726,1176056,2022-11-30
27207341ffeaba3e,,28008521,489082,0,0,28497603,2022-11-30
b6860c37e9151a09,t-mobile,452225052,46386507,10318,4977,498626854,2022-11-30
91d36914a8dc7279,mint,171154429,7394646,0,0,178549075,2022-11-30
c6d9f7aef79dd019,mint,35806282,4447372,0,0,40253654,2022-11-30
c53a44ae365f4cca,mint,265613948,15067582,134260,51964,280867754,2022-11-30
ee3f7af7be39e151,,1094910013,58701738,0,0,1153611751,2022-11-30
67ed3244892ea207,,126246739,1890520,9528491,259427,137925177,2022-11-30
a3376fd9b9180487,t-mobile,474933968,32013988,1237250,262023,508447229,2022-11-30
01646964ab50edf4,verizon ,547692130,64787272,6661,1637,612487700,2022-11-30
b35ac745d911314d,t-mobile,5121686807,103615721,998708,134723,5226435959,2022-11-30
524370ca8d5d14bc,at&t,324535340,33891167,22302,16217,358465026,2022-11-30
6dca91c9b2ed07fd,mint,907375813,82588040,103337,35979,990103169,2022-11-30
48331b1c30930e48,,313754325,7529374,0,0,321283699,2022-11-30
d7ced380900f0640,at&t,788330986,71910933,190683,70797,860503399,2022-11-30
cca1a76d82820b5c,verizon ,310707672,3672743,1964953,251931,316597299,2022-11-30
841cb231ab4c176e,verizon ,560798390,12006454,753794,84016,573642654,2022-11-30
fdd50ec505fe88f4,at&t,498218151,43807784,0,0,542025935,2022-11-30
e46aa931b5bf76f7,at&t,1043835740,78466833,0,187,1122302760,2022-11-30
d876c754df3cdc66,verizon ,608992839,25858011,20775389,581468,656207707,2022-11-30
3a03905d5cc8e67d,Â ,1043668227,65860202,838198,114839,1110481466,2022-11-30
576d7472b6d89e90,,4899832,472903,0,0,5372735,2022-11-30
6b8134e90c645b6a,verizon wireless,579146771,34731102,1104329,154381,615136583,2022-11-30
4eabec467bdb2fb2,verizon ,1630742147,75156691,1470912,329009,1707698759,2022-11-30
1a504da751a88a57,verizon ,428499830,42094089,1385847,54910,472034676,2022-11-30
2b3c3af83b8f3bf1,,198219952,23655713,605031,53126,222533822,2022-11-30
2f5ccc4fd44d1c72,t-mobile,613669138,45233585,214631,72519,659189873,2022-11-30
66586d950635f590,mint,1196847938,73934342,18953887,391548,1290127715,2022-11-30
4a114ff206bb9e2d,verizon ,865943977,82968657,6661,1637,948920932,2022-11-30
ee3f6ef371b9be11,verizon ,800527,258981,223772,80411,1363691,2022-11-30
cd0a3c9e4bde5e91,,1436875762,121916052,2752759,1078229,1562622802,2022-11-30
18c162872fb2d16b,at&t,665991392,49538156,1641291,370283,717541122,2022-11-30
823232bc7e2d8a20,at&t,648192188,45182138,27218,9901,693411445,2022-11-30
67baeeaab11e91fc,at&t,783072698,73245141,1037293,229249,857584381,2022-11-30
d3a99381faf25fa3,,57711050,8893592,0,0,66604642,2022-11-30
67edb657bb00f8a2,mint,1174458406,69115775,1963045,235192,1245772418,2022-11-30
a702fb8923be9cd4,,312018248,9907615,0,0,321925863,2022-11-30
b2a82421904a4533,at&t,493074393,49907565,47124,13738,543042820,2022-11-30
1b07bc3983c1836e,verizon ,1172172274,49915924,22737,6740,1222117675,2022-11-30
49aa4cb738bec1ea,t-mobile,232652907,30110662,695105,39408,263498082,2022-11-30
e05ea4767215b10d,t-mobile,836170439,50431666,0,65,886602170,2022-11-30
0057bad76601a1d8,,145080479,1278556,0,0,146359035,2022-11-30
998e70a12faea149,us  mobile,612208975,56997013,710579,44793,669961360,2022-11-30
ea5b7640ea79e049,,338269317,33400904,1515847,261095,373447163,2022-11-30
a444db83fbe5f34d,,17915,6308,0,0,24223,2022-11-30
9e069340450fdfac,t-mobile,571609810,59803663,6744,2020,631422237,2022-11-30
6fdadd15b51b86ce,mint,280772444,12623129,1784533,278377,295458483,2022-11-30
a45d047dadb68535,t-mobile,0,0,2096974,328753,2425727,2022-11-30
55be4bd2b579dfdc,t-mobile,787753256,75298132,0,3400,863054788,2022-11-30
84fcb38f16a47e75,mint,1142922264,56459346,864036,135581,1200381227,2022-11-30
3ee2c06fd9384254,mint,232688658,10096934,24364,27963,242837919,2022-11-30
dbb5caf7ba958170,,253847587,3446555,0,0,257294142,2022-11-30
ce7c5f55cc5a7762,metro by t-mobile,206652583,8823068,0,8591,215484242,2022-11-30
5da5f6508dcf1792,mint,830641743,67391602,54219,23135,898110699,2022-11-30
3d5b72a7e030dd90,roam,146448591,2369243,0,0,148817834,2022-11-30
f0a8803ec04f4889,mint,1311861216,94399361,1775331,347710,1408383618,2022-11-30
695c0c2e5cacc96c,mint,6973,12219,1231081,237250,1487523,2022-11-30
2e146116778de3b9,t-mobile,3138884261,97228969,1611488,288946,3238013664,2022-11-30
455166339bb78972,hello mobile,921190970,75432927,2687,25425,996652009,2022-11-30
1fcadcf627323a47,mint,750195625,76254813,8102,2117,826460657,2022-11-30
a4d491918df68af1,,205736304,4190069,0,0,209926373,2022-11-30
e5808cf9f3f7abae,,116913079,1855251,0,0,118768330,2022-11-30
a5fa254c340b2689,verizon ,297591,155014,142812,52787,648204,2022-10-31
a80ef0fb31903fcb,t-mobile,1575027279,46704699,1459302,167627,1623358907,2022-10-31
9cdc36850db6b753,mint,979680048,67328467,20784,6780,1047036079,2022-10-31
1670551152ed9445,cc network,959404373,33354504,39140,9554,992807571,2022-10-31
a99aa9755bc379c7,mint,222798,258309,7025,1948,490080,2022-10-31
c054c55106b5d82b,verizon ,1178322,631855,159548,74314,2044039,2022-10-31
fdcf3da5d65f39f9,,57767951,926046,55742,20160,58769899,2022-10-31
d6dacdf29bd5b4f9,mint,55871054,2580261,255434,181026,58887775,2022-10-31
508973eda65710db,,27478,9073,0,0,36551,2022-10-31
d7d2ccf562f04064,verizon ,19158389825,415569476,684975,42837,19574687113,2022-10-31
105fd248a65578b7,verizon ,16802983507,330087183,615899,120142,17133806731,2022-10-31
aea0955ea633126d,t-mobile,447132321,24887547,895455,182646,473097969,2022-10-31
0afcbb880ab55ec9,t-mobile,948443512,79140855,928978,127593,1028640938,2022-10-31
16ee1d2c6bc67d23,mint,0,0,737730,405763,1143493,2022-10-31
2bf821ebaf9b3bbd,mint,15989923,343680,0,0,16333603,2022-10-31
5537c5a23e405432,verizon ,81413673,1624247,38898681,1238023,123174624,2022-10-31
ac13c89eeee79f3a,t-mobile,0,0,573149,213831,786980,2022-10-31
e357989c0dc09cb8,viaero,657202113,14425921,0,0,671628034,2022-10-31
51ea5d8bf574799c,,787011006,66236399,0,0,853247405,2022-10-31
f3fd62456c539f8e,verizon ,24906345778,403513483,3875,72816,25309935952,2022-10-31
29981e0ef0ec2ead,telekom.de,1312794236,69911545,6853,2199,1382714833,2022-10-31
1cf400b37f0693f2,t-mobile,0,0,9313,2670,11983,2022-10-31
8429a5e2d4e968ac,verizon ,324869046,33582119,888065,112917,359452147,2022-10-31
4c54b02148e6d93a,mint,646970,236000,22291,5550,910811,2022-10-31
37f5198dd499648e,mint,174031,58125,730384,231326,1193866,2022-10-31
5426329a2873d70f,t-mobile,527240247,13105615,0,0,540345862,2022-10-31
72b460c3b5642d4a,verizon ,2626537710,50976303,476,3127,2677517616,2022-10-31
35cb6b435bca22b6,t-mobile,949895044,80005793,1257077,194652,1031352566,2022-10-31
aa411ee9f4bbe69c,t-mobile,2877180651,34731878,1087846,217331,2913217706,2022-10-31
d6ec7130edd4b38b,t-mobile,1198136995,24808268,24831,7131,1222977225,2022-10-31
9fb08315379fe16e,t-mobile,40168562,1440942,0,0,41609504,2022-10-31
0dba080bf728e415,t-mobile,349794852,61012547,1375322,267508,412450229,2022-10-31
b0433896bb842001,mint,1048873400,60666035,0,0,1109539435,2022-10-31
404ab375e7388e4a,mint,552127,212272,111810,42075,918284,2022-10-31
b1e021ea189ed4c0,mint,1904321088,27577157,43642779,1272801,1976813825,2022-10-31
7c399b943e5ac3ac,mint,1155688349,70339285,1164153,232580,1227424367,2022-10-31
a3c60ada0950dcdc,,1602459136,21327767,0,0,1623786903,2022-10-31
7757bcdc1fd5ee2c,t-mobile,155644522,2445846,19382927,671384,178144679,2022-10-31
38f53a693dc0990e,,2554967672,66877745,0,0,2621845417,2022-10-31
ccc82afddd8d9c35,metro by t-mobile,1120187,278392,601222,99198,2098999,2022-10-31
d566e2b8389219a2,mint,722976049,56569848,0,0,779545897,2022-10-31
022a90754e723ac2,mint,1042912565,80161357,43590,15320,1123132832,2022-10-31
ccbc211b77af192b,mint,379423884,44949288,0,1363,424374535,2022-10-31
69a1e847c4cfc3e7,,727517783,44698106,70300,34763,772320952,2022-10-31
ed1490a632f18be0,mint,84,84,0,0,168,2022-10-31
4e2f59ae34020a83,mint,78193799,6384820,491399,138245,85208263,2022-10-31
d2fd11e1d78f3888,mint,855578768,76196240,6836,2372,931784216,2022-10-31
3395adeecc7ef567,mint,888618,252241,51059,14994,1206912,2022-10-31
d758b07a5bae101f,t-mobile,23690341,773023,0,0,24463364,2022-10-31
ecc6d5770b88026d,t-mobile,725672,563225,724916,251991,2265804,2022-10-31
a63263a4677ee66d,,643586,191360,788568,269281,1892795,2022-10-31
1583c57c8e5d56be,mint,632164141,19935281,6863,2033,652108318,2022-10-31
0d12e6522983381b,mint,4877962120,111942416,40336,12090,4989956962,2022-10-31
e5642c3bb0652c82,t-mobile,0,0,34613,9546,44159,2022-10-31
d4b571f3e2d400b6,metro by t-mobile,826800,223099,4433,57613,1111945,2022-10-31
e0403b7c508c9975,,786566,219333,72318,27454,1105671,2022-10-31
374cd2c683f2161d,mint,482426,517777,972766,416930,2389899,2022-10-31
9a35251f1d718fc0,,164252,215646,0,0,379898,2022-10-31
136fa8a066506849,mint,320269,102702,747374,292948,1463293,2022-10-31
aab34dd94a9e3b32,t-mobile,18621085,343562,0,0,18964647,2022-10-31
5687e7ed7c32abf2,t-mobile,42884,19632,45008789,1746878,46818183,2022-10-31
3906908a495ec94b,mint,357653974,12142008,11882,78445,369886309,2022-10-31
cbf929ef5500996b,mint,699245118,27789928,657524,36170,727728740,2022-10-31
6b193814b11b2f68,red pocket,721880754,69935321,1050786,174574,793041435,2022-10-31
08a691c7d7a62773,mint,556869737,45168987,645058,496752,603180534,2022-10-31
f0a01d877a8c0b31,mint,327341,141307,729867,237623,1436138,2022-10-31
451a50734da546fe,t-mobile,9256830060,150273621,1165512,209063,9408478256,2022-10-31
e485a461124e8a28,,58300867,1360493,0,0,59661360,2022-10-31
aecdd1deda819d91,mint,348206863,6784365,0,0,354991228,2022-10-31
d59d5dcc60c4ce6c,mint,377199354,4903328,120335638,1709444,504147764,2022-10-31
bfa1c07fd5359b0b,mint,829430362,62011457,674936,82429,892199184,2022-10-31
d541eb085c4d7bbd,,0,610,0,0,610,2022-10-31
d6def376cca98629,t-mobile,733952062,60945951,98230,40242,795036485,2022-10-31
65a7f3e4877b5012,,806577,225831,12399,4185,1048992,2022-10-31
f9c36daafae30042,mint,912239754,38647858,75541,44408,951007561,2022-10-31
cbb0dbe25f13a2f5,mint,391345,162161,0,0,553506,2022-10-31
948b4de16dcea367,t-mobile,502627350,36753418,126757,41903,539549428,2022-10-31
7a55f39389f27417,,182418925,3489600,0,0,185908525,2022-10-31
a7d20f52673edaac,,500277,431244,0,0,931521,2022-10-31
1f8ef1ab759f43a4,mint,146133789,13048167,0,0,159181956,2022-10-31
ecacae4c1e47e162,mint,8854,2075,7364,2164,20457,2022-10-31
d8d8d965ebea8a6f,t-mobile,4459508234,123300119,1548522,308629,4584665504,2022-10-31
cf3a973e1c229ae6,mint,38694972,1192103,0,0,39887075,2022-10-31
5d17cb926f2847c9,mint,36242,117230,54918,20002,228392,2022-10-31
e78ab68adf648a3e,mint,842619,213667,797840,252371,2106497,2022-10-31
cdfcabff9d98298d,mint,501543592,11355130,21487,7289,512927498,2022-10-31
72ee7336c198f1b0,t-mobile,906597589,62380271,1139343,216092,970333295,2022-10-31
44bbaa05d5d6ac02,t-mobile,776042422,62268268,749790,70513,839130993,2022-10-31
2b7047bcbffce5e4,,148240976,2724333,0,0,150965309,2022-10-31
d80a8f00130d8ec6,at&t,294785,176665,12332227,305595,13109272,2022-10-31
b8e3a74353fd20f3,mint,366056713,57734945,6828,2342,423800828,2022-10-31
e19200dee37a05ee,t-mobile,903545369,59096103,28777,10425,962680674,2022-10-31
5f78cfbb9729d3e2,t-mobile,1872434034,107039603,1308,1672,1979476617,2022-10-31
8aaf4c32fe72034d,,374750,120686,480447,172276,1148159,2022-10-31
cc1e72a5ad70ac42,t-mobile,656943371,43296523,810951,106600,701157445,2022-10-31
7d824eca8b60003a,mint,284305759,10348808,0,0,294654567,2022-10-31
6f84892e1442b663,mint,762015167,44363542,0,0,806378709,2022-10-31
834768711c434eab,mint,974790764,36212963,6744,2127,1011012598,2022-10-31
e7c244d7b5a801ab,mint,1958013526,45982135,1969162,371467,2006336290,2022-10-31
dda4ba4f234ca9d4,mint,1274602543,58385372,353594,35999,1333377508,2022-10-31
e750d1c4c7258b71,mint,3718644378,88473338,345254,115248,3807578218,2022-10-31
a4e52c66c35fa680,t-mobile,100393828,1572561,794386,252888,103013663,2022-10-31
195283af4eee78cd,mint,899106609,61046568,752016,63499,960968692,2022-10-31
9200224f0be52015,mint,687680792,18477206,0,0,706157998,2022-10-31
4151088b891215c0,mint,736055646,43447508,888513,125215,780516882,2022-10-31
8f97ac8fbeafa200,mint,469327439,44178252,7235,2368,513515294,2022-10-31
ac299ec3d4905131,mint,1384656,630634,35551,307484,2358325,2022-10-31
620b415f7d1a73b4,mint,430844,129094,818001,220507,1598446,2022-10-31
df5a992ce72a4275,t-mobile,2883624208,85730843,1380972,329061,2971065084,2022-10-31
885c4de68715c333,at&t,46344210,2519464,263279,79705,49206658,2022-10-31
4a1d13212d3df504,mint,348102331,6290412,0,0,354392743,2022-10-31
1c690c00e3362060,,694396418,21205207,28947,2605,715633177,2022-10-31
45a7c0c5cf57f5a7,t-mobile,933638074,69565213,841824,250506,1004295617,2022-10-31
846ea4c6c916f23d,mint,593591810,48881767,17478,10762,642501817,2022-10-31
e6997d2f30a99bc5,mint,2970295807,61496455,656908,38822,3032487992,2022-10-31
8ef15eb4af3c7239,,116327,33728,31874,11694,193623,2022-10-31
4e9703cf715bdc34,,371368466,14747306,0,0,386115772,2022-10-31
63ebcc7eda51ef94,t-mobile,654374090,71559622,731734,62832,726728278,2022-10-31
c3be4bf7557b7785,,852687,251619,1162,19252,1124720,2022-10-31
d814647f49be631a,mint,864150761,69636179,7044,2441,933796425,2022-10-31
c6048d62b96d2c7f,mint,126525005,4080155,16691,4250,130626101,2022-10-31
619b6a80f4b99c18,mint,701086657,68738498,2019209,356679,772201043,2022-10-31
9d5175df0576fd71,t-mobile,482578315,51437022,8431,4410,534028178,2022-10-31
3ab1904aeafd3945,t-mobile,884319986,78310824,110806,34232,962775848,2022-10-31
0017b012bcd2bc51,mint,1510352535,61420386,72,63,1571773056,2022-10-31
1d8b612b675068dc,mint,661849207,35595526,1515709,226992,699187434,2022-10-31
f94f15a1577f6415,mint,676906897,59288283,140837,62617,736398634,2022-10-31
9a5cd5e26db1a63c,mint,512230608,49070078,1536763,238908,563076357,2022-10-31
7e84d52b2d399816,mint,3097800407,99848664,196009,83042,3197928122,2022-10-31
edf1846097066641,,308176055,33603695,27366,8044,341815160,2022-10-31
e050bf0ff84b8957,mint,1742332342,13555645,11495,1102,1755900584,2022-10-31
785ca858024d295d,,722222974,49601813,1659910,237690,773722387,2022-10-31
be1dd3348042073e,verizon ,757518320,74692889,690973,281719,833183901,2022-10-31
bf88e2f3a3eac0eb,verizon ,673511710,38136215,1422751,303836,713374512,2022-10-31
3920c65c4ccb9ff5,t-mobile,1511837163,99026995,1892438,270534,1613027130,2022-10-31
f41382241ee4d3a0,verizon ,520548560,38355042,2006831,285609,561196042,2022-10-31
6cd4ba5b86849f07,verizon ,1334040366,65243357,448,221,1399284392,2022-10-31
53cf5020814135cb,verizon ,330417881,9350458,1809804,249433,341827576,2022-10-31
24efa312a390492d,t-mobile,823512411,50006376,168594,74050,873761431,2022-10-31
98e3fea1eeb98308,t-mobile,487215136,43294302,688708,89613,531287759,2022-10-31
007c3200b22b7bbe,mint,971085119,57393963,0,0,1028479082,2022-10-31
fa65a5f74adecf12,mint,118757105,2600918,0,0,121358023,2022-10-31
df1120b73cd04cec,mint,323702439,7531516,0,0,331233955,2022-10-31
4259751d1aeaf895,mint,584629,171894,254044,91485,1102052,2022-10-31
25ca870b99bf6bae,mint,825456,234358,32757,9799,1102370,2022-10-31
e5e5f992a9092db5,mint,7527256111,190123161,31404,11448,7717422124,2022-10-31
3f04d875c321eaf3,mint,766618663,22867234,581907,118884,790186688,2022-10-31
d6b2af6a672ccc5c,ting,378138265,28804247,0,0,406942512,2022-10-31
96444ff8c629509a,mint,458126371,53274864,376180,128115,511905530,2022-10-31
9629fcf24c47b115,mint,645305413,18965293,579174,78995,664928875,2022-10-31
687e9403546316f1,,291466548,3987740,0,0,295454288,2022-10-31
a0c6472ae8b70eb2,,887074,232479,0,0,1119553,2022-10-31
65e447f5ab323e05,t-mobile,881236691,50171476,1780589,357790,933546546,2022-10-31
1e71b1a1eaa416c9,mint,716469,217299,6399,2412,942579,2022-10-31
2d4b78cd5b4e7f20,mint,780993,229621,143787,172904,1327305,2022-10-31
aeec9b11b088ba44,,74317734,1011519,0,0,75329253,2022-10-31
00648d09177d4b0d,at&t,521191738,72396109,1046673,138298,594772818,2022-10-31
153b8101d871ba02,verizon ,701344046,80762885,416255,57524,782580710,2022-10-31
5335d63c74c250e4,verizon ,649633016,109327934,892013,98623,759951586,2022-10-31
9c00b3f8b88b9d77,verizon ,60514487,603139,803234,311021,62231881,2022-10-31
a709e8781539f9e9,verizon ,601227011,68703021,0,0,669930032,2022-10-31
853f5bb5d093411e,,550171812,52933681,1567,16218,603123278,2022-10-31
294a012c77ab24be,verizon ,77317277,1984189,191550,60830,79553846,2022-10-31
008acb16b4959047,,443120,2018337,0,0,2461457,2022-10-31
ae5d20c4782ac3bb,mint,3142469231,66499394,620747,22563,3209611935,2022-10-31
65cb2d8d0fd21b3e,mint,8258625806,88933847,1270044,262195,8349091892,2022-10-31
843c356576ca7c43,telus,490225640,49646664,1661175,173577,541707056,2022-10-31
438cfb020bfd825c,at&t,0,0,941205,298516,1239721,2022-10-31
13fbe6cf9f2d8765,verizon ,1093044927,51010858,858702,89230,1145003717,2022-10-31
c181e59f7f4cac02,verizon wireless,366495,1354689,84,84,1721352,2022-10-31
3d8b0cac59b52cf0,verizon ,0,0,643336,51291,694627,2022-10-31
bb9b3c41feeb161e,at&t,989226378,65663491,167692,58478,1055116039,2022-10-31
ee74268068fd2cd3,at&t,0,0,33841,9843,43684,2022-10-31
5c634041620bff87,verizon ,1267842274,93627780,0,0,1361470054,2022-10-31
0d6e4a96fb58ffda,at&t,755307434,68429527,22074,6781,823765816,2022-10-31
9be10607fb11ba59,verizon ,3963264961,104877445,2227429,371692,4070741527,2022-10-31
40f492c1539b6786,mint,474823459,55462086,1301954,262280,531849779,2022-10-31
bf07907c905b3148,verizon ,1078143021,56578288,1350482,566955,1136638746,2022-10-31
447ea6b4ac47dfc2,verizon ,756037387,50715530,1044083,152394,807949394,2022-10-31
d138d6c0d6cc1a0c,verizon ,1839217777,78022325,21515,7591,1917269208,2022-10-31
e1d970ef245d1a9a,verizon ,918948363,70993174,1897337,239874,992078748,2022-10-31
e0c65eb1536e474f,,25302,7826,0,0,33128,2022-10-31
243c322c82cd0dfe,verizon ,26568859,5729259,1303352,61324,33662794,2022-10-31
679dd6cd1a044a12,verizon ,843683674,72289378,1013570,152471,917139093,2022-10-31
ea22274b9888f0b3,cricket,3030509073,53620287,1319560,270728,3085719648,2022-10-31
f4a70c8033983fd2,cricket,433242198,32593016,0,0,465835214,2022-10-31
8f966f38a81dad3a,,28941,47987,38426,65875,181229,2022-10-31
10d0bdd19fbf3839,mint,384702560,15823080,373896,136639,401036175,2022-10-31
8a158125c94b2228,mint,380268984,13120018,31970,11173,393432145,2022-10-31
30427d6c04abae97,,146062494,2759509,0,0,148822003,2022-10-31
9fbc1b91a6f00b11,verizon ,59065195,9684802,1318499,77772,70146268,2022-10-31
b2474ed780854a92,mint,112050264,1504577,0,0,113554841,2022-10-31
883aec4c75f5bd7d,mint,796597826,29458451,822762,137226,827016265,2022-10-31
e9b4dac1321e5933,t-mobile,496919481,55820983,1000,771,552742235,2022-10-31
ec10c1f20ecf2210,mint,420539177,36721343,187799,62834,457511153,2022-10-31
52c217fe4fb61fe4,t-mobile,0,0,357642,106160,463802,2022-10-31
e973cda79094c5cb,mint,311998,81671,0,0,393669,2022-10-31
d9109e7cdab11934,mint,451295041,29824706,99627,41168,481260542,2022-10-31
fcc920823b807848,mint,1092839577,70026484,6672,1948,1162874681,2022-10-31
9b5444c1cc95909d,t-mobile,464351,132234,49007,13344,658936,2022-10-31
6e04447274c7bdeb,,688901,187826,0,0,876727,2022-10-31
3065764efe8c36a4,mint,21711,7639,0,0,29350,2022-10-31
8f13275237db3f2a,mint,771198043,57471747,706014,78092,829453896,2022-10-31
55e346cfe97d1da4,cc network,40033853,2314540,37819,8422,42394634,2022-10-31
4a52d739f9499d55,mint,1667466266,201079089,2872526,510018,1871927899,2022-10-31
f4d3a8ae4187721b,,3689036,53865,0,0,3742901,2022-10-31
35d3a608bc57b9fc,t-mobile,479590591,53502427,157234,77831,533328083,2022-10-31
924142e7ca4604eb,mint,852807615,60668557,307,4360,913480839,2022-10-31
b4a81b4d0cf6c97d,mint,30360,125808,7671,2117,165956,2022-10-31
d2d90aacd9e15696,mint,27067783,4510553,1157165,186463,32921964,2022-10-31
48bc6e835433fbff,mint,740667762,48243478,2063389,787863,791762492,2022-10-31
bcc3e1ff9b67048d,mint,334578995,31586112,174348,61444,366400899,2022-10-31
157c83764dc7b9ee,t-mobile,1017666593,84563258,226561,81941,1102538353,2022-10-31
57a4403dcb030d48,t-mobile,824671599,56173286,122790,39159,881006834,2022-10-31
91631519f2dfe1f5,mint,0,0,33119,7853,40972,2022-10-31
ce33277099ccffb5,at&t,2683978975,77372432,192873,81385,2761625665,2022-10-31
97921abfccc97946,verizon ,1426559362,21954435,33907552,938508,1483359857,2022-10-31
cd0f577dcd5f26b3,mint,32859489,6339031,739158,617802,40555480,2022-10-31
b64970937df1a57d,mint,3837643638,113760805,3678,1283,3951409404,2022-10-31
6eb86d5edc0872da,,233237524,12536561,0,0,245774085,2022-10-31
b095f015ac96feea,mint,508364159,36243171,61817853,2151231,608576414,2022-10-31
6ed45f5d3d8dd4ae,mint,165931505,18838446,21948058,1197135,207915144,2022-10-31
492a369d832f6b59,mint,1155392588,73845934,44980,17426,1229300928,2022-10-31
fce9737c6433e8df,mint,96216268,15513266,938797,211058,112879389,2022-10-31
6d780c32e26cd94f,t-mobile,89161379,1364951,0,0,90526330,2022-10-31
b2e0c780ebcbccc2,mint,0,0,264726,58528,323254,2022-10-31
f7f865ded2d4d932,verizon wireless,967611,254046,84,250,1221991,2022-10-31
f696eb277b6588d2,mint,10214676044,186929531,0,279,10401605854,2022-10-31
114e195260bd9cb1,mint,55897,13804,0,0,69701,2022-10-31
d8e4084217a3bf81,,1289524039,61420580,14628,142610,1351101857,2022-10-31
8599904a27f08614,verizon ,0,0,2140589,299310,2439899,2022-10-31
274be17afd773840,at&t,1905707158,42698974,691599,57335,1949155066,2022-10-31
a90ea3a14d46b044,mint,803348921,50518421,1073301,182308,855122951,2022-10-31
5e2fcebd45837dc2,mint,3630671344,79166591,1168830,209379,3711216144,2022-10-31
23e958e517712574,mint,4543998875,94818271,709508,54064,4639580718,2022-10-31
1809d22e658eb049,verizon ,736197532,68290523,59768,16061,804563884,2022-10-31
c20ce21accb9a4b5,verizon ,0,0,0,142,142,2022-10-31
e6bca7658439a92c,,545212207,77191534,113057,35663,622552461,2022-10-31
9c4815bcbdebab49,verizon ,3707789706,84224587,450,170,3792014913,2022-10-31
37a6b87cf415c874,t-mobile,0,0,79033,29315,108348,2022-10-31
fcd80fffa55677b7,mint,562299082,42858629,2036054,341270,607535035,2022-10-31
8c5a4009591f9d9b,mint,959484838,101720159,121472,45660,1061372129,2022-10-31
719d990428bdf40c,mint,45315,14968,90491,34235,185009,2022-10-31
7e34ac328549bac3,at&t,590411,195745,0,0,786156,2022-10-31
63f49e276929475c,mint,612015920,8916570,0,0,620932490,2022-10-31
bffcb8da94d4a395,mint,925773,183489,119358,45047,1273667,2022-10-31
9a276d9146fd7f08,mint,0,0,92401,33938,126339,2022-10-31
c0f1458be8d0a6f6,ting,931289128,66620683,0,340,997910151,2022-10-31
18977e4c770e52da,mint,1549042712,24803021,20516944,540085,1594902762,2022-10-31
33ced21cbb798666,mint,967043031,75268058,57786,22315,1042391190,2022-10-31
8d72152f62d7ca78,mint,526646090,88377071,582,10251,615033994,2022-10-31
d144f94b18edba03,mint,512966655,48203637,227386,80384,561478062,2022-10-31
b379980c89300a6d,mint,28122,9181,332,1340,38975,2022-10-31
beb2cb5d92c97578,t-mobile,1117129633,40945857,6863,2033,1158084386,2022-10-31
c94a3da907e4ff8d,t-mobile,841908,254774,63944,20937,1181563,2022-10-31
970d5bbda010a903,verizon ,617647777,57804296,85175,8705,675545953,2022-10-31
5dda0d33bccee1e0,mint,834519770,56983878,77535,27122,891608305,2022-10-31
0034aa695dda4a63,t-mobile,835868,251931,402064,156587,1646450,2022-10-31
4afed5b4dff0ed7e,mint,880690658,59000224,1823935,236957,941751774,2022-10-31
ab567715b07e08b4,verizon ,68497532,13213949,1893572,265614,83870667,2022-10-31
7e950c6f11272d16,verizon ,908510869,72170490,700170,49123,981430652,2022-10-31
1decda4906b28247,,2765367704,58139290,229090,105055,2823841139,2022-10-31
aff4943fe8931d50,,782793830,53997901,0,0,836791731,2022-10-31
661fe90eab1e5814,at&t,1118259969,43728887,714064,72678,1162775598,2022-10-31
1f01c3bbb72acbe6,at&t,0,0,78983132,571284,79554416,2022-10-31
17703d7b9f72ef7d,verizon ,1851857852,75727980,416,170,1927586418,2022-10-31
e3fadffbcb743ad0,verizon ,1086948809,50989677,1325821,256333,1139520640,2022-10-31
84e1dd1b93f5b2e8,at&t,506208523,55748516,62433,21172,562040644,2022-10-31
331454a27d67dce0,t-mobile,987422088,69791052,1055383,41027,1058309550,2022-10-31
2a52888d4726eb53,at&t,457704471,22176475,2560622,488932,482930500,2022-10-31
1fc26d934cc5d52a,Â ,713312658,47881063,1373127,174732,762741580,2022-10-31
5c1cc21c2d5949fd,verizon ,357608637,41174325,1317955,73245,400174162,2022-10-31
c3a315618d3c29d4,t-mobile,140462566,14784589,21250,212423,155480828,2022-10-31
2696cf9a5d120bbb,mint,447803918,13019696,45251,17505,460886370,2022-10-31
d3021473734ede08,at&t,0,0,38296301,1909323,40205624,2022-10-31
2df3e60fb513f880,verizon ,1118939846,59318621,994045,139810,1179392322,2022-10-31
0ef3fc251d4fe646,at&t,352430525,24342131,1868691,229483,378870830,2022-10-31
a894be32e8b8790e,verizon ,1652709618,76651786,1024783,156358,1730542545,2022-10-31
ad0850c9bdccfc91,at&t,1465750638,68023934,81462,47669,1533903703,2022-10-31
a91b6dd985e9d579,verizon ,414262181,16459806,1803440,221508,432746935,2022-10-31
8664a639e4c3c5ec,at&t,832422264,62321953,680108,40149,895464474,2022-10-31
b7a2415118af38f7,at&t,369112462,62665172,185209,68435,432031278,2022-10-31
fb6327f498ebccbf,at&t,948790518,78846378,290926,109266,1028037088,2022-10-31
e4d003022d201b27,verizon ,749912744,61849808,101438,32527,811896517,2022-10-31
6232df7ffee1d8b9,at&t,878607745,51482951,87421,39001,930217118,2022-10-31
0161601bd5ed3524,mint,3751112339,96206113,1828794,246676,3849393922,2022-10-31
831981d301bc87c8,verizon ,827817452,57555774,13623,4978,885391827,2022-10-31
a197836cb48676ea,t-mobile,151572516,14016940,1124278,211195,166924929,2022-10-31
2101ec98b73354a2,t-mobile,543556218,58092774,0,65,601649057,2022-10-31
37c82decc16ca184,mint,1426991486,25189949,1317527,148145,1453647107,2022-10-31
482e33798b6fe998,,147731552,2701383,0,0,150432935,2022-10-31
aa5fe1ca986d9c0f,verizon ,3388872436,54029185,6574,1585,3442909780,2022-10-31
d91e748299421f70,t-mobile,414419012,11880979,104,104,426300199,2022-10-31
41b3d47adbdb8f51,mint,1149054497,90883119,777631,86124,1240801371,2022-10-31
7a0e4c523a455bf2,,1347403128,63087515,0,0,1410490643,2022-10-31
7b2526aa9c0d2fbc,metro by t-mobile,872988,232261,209638,65560,1380447,2022-10-31
2e6272d249f6ad2f,,558205632,8115083,0,0,566320715,2022-10-31
78b1d3d4b1784c04,at&t,47774574,5876188,0,0,53650762,2022-10-31
3868a1f77d50b3ae,mint,1065,305,38340,348328,388038,2022-10-31
bb2e9aaaebf54a47,mint,131547228,15329318,153115,59229,147088890,2022-10-31
ecc3ce9ec5d769ec,,84,84,16590,176613,193371,2022-10-31
ad137849a4387af7,t-mobile,443300193,21336807,0,0,464637000,2022-10-31
41d1df884cb94034,,3373615,174526,0,0,3548141,2022-10-31
cb1086eb239d113f,mint,25454,113158,0,0,138612,2022-10-31
25b8aec9b962ea7e,t-mobile,336198842,40310870,0,3145,376512857,2022-10-31
19f75443853381ba,at&t,51984,9272,773601,449295,1284152,2022-10-31
b77f41ef7c19473b,verizon ,909678665,72030845,69020,20280,981798810,2022-10-31
3a7a82ef272f7e5d,t-mobile,312784248,17879588,79967,25193,330768996,2022-10-31
72440a9876c15137,t-mobile,645679238,46164596,1318346,68708,693230888,2022-10-31
439b23dc1d508c7d,,320545192,6481963,6356,1749,327035260,2022-10-31
124d7d0bd53b32c1,verizon wireless,697855873,40618143,985976,363406,739823398,2022-10-31
aee81d0daf364b4c,mint,3661841449,94701291,14179,5353,3756562272,2022-10-31
49203044af79db29,at&t,636060,203887,576712,172268,1588927,2022-10-31
fd57663ef7d30489,t-mobile,392953046,6836834,642008,186240,400618128,2022-10-31
08ba6f9108604822,mint,0,0,152102955,993980,153096935,2022-10-31
a5149d86605762fb,at&t,375777,116715,437286,137337,1067115,2022-10-31
8c6fbad1f5580ce9,us  mobile,2987470645,108888044,2539268,463790,3099361747,2022-10-31
115dcd6abcf5934e,t-mobile,749981263,42876255,198126,72659,793128303,2022-10-31
32df22c4c3d2fcc4,verizon wireless,298834266,4785299,2968,51457,303673990,2022-10-31
39d9e0e524019c13,mint,644449727,49790566,628745,32356,694901394,2022-10-31
81efb686453e1323,at&t,0,0,1295877,130638,1426515,2022-10-31
3ad11e171862adda,verizon ,1324,5728,1799212,241323,2047587,2022-10-31
d9df78e5bf265097,verizon ,434855326,21378886,926600,155762,457316574,2022-10-31
699b6a2c2230b7a4,extended network,539902,886585,1158578,99935,2685000,2022-10-31
e60a9cdca7e518ec,verizon ,1671647841,88251168,136367,40807,1760076183,2022-10-31
930531326ba71fec,xfinity mobile,4814431773,90894312,6661,1689,4905334435,2022-10-31
0e677e9dcbc2a58c,verizon ,514273443,49982639,0,0,564256082,2022-10-31
1a59c92bcd0e3e06,verizon ,4235836335,83716137,1069333,70118,4320691923,2022-10-31
37eb330ea6b9ac75,verizon ,8035584204,109655934,783684,83026,8146106848,2022-10-31
1aac8a420803b788,at&t,52303572,489865,0,0,52793437,2022-10-31
d65f6f55acb6b24a,verizon ,1237313391,60123833,682480,107643,1298227347,2022-10-31
19333be490c7483d,verizon ,494684669,51275052,1796099,209904,547965724,2022-10-31
7c63033517954da6,,177381067,3995937,0,0,181377004,2022-10-31
56068fb22fcd57d3,mint,1334949434,70177092,34545,9626,1405170697,2022-10-31
c01affd742b1694b,mint,388995838,27908574,0,112,416904524,2022-10-31
dc9a661c42a9a057,ting,1049704229,54907960,140214,49145,1104801548,2022-10-31
68b6dc1cd57d5ad4,mint,468763415,29164102,0,0,497927517,2022-10-31
88d79ec6420a7f4c,mint,514747045,43227544,552924,28867,558556380,2022-10-31
50bab27d133893d5,,229451218,13037862,0,0,242489080,2022-10-31
8f1ea08749c3a03d,mint,802123922,70596739,890656,130401,873741718,2022-10-31
80db3ed82c202ac5,,147372658,2644616,0,0,150017274,2022-10-31
08db4503555f28ce,,147670887,3998020,0,0,151668907,2022-10-31
749c6cfd327b4617,,148268464,1272506,0,0,149540970,2022-10-31
d91b15343b6c4182,mint,665995490,74212873,42534,16118,740267015,2022-10-31
2b0dc25bda9d29fd,t-mobile,1025813129,67619011,6557,1951,1093440648,2022-10-31
74b47b757d724bdd,mint,0,0,1357956,78224,1436180,2022-10-31
e65b1e754c4187e8,t-mobile,462219511,56096728,1846096,224448,520386783,2022-10-31
6d62c905a901e5a2,mint,1865674,117303,5475337,574574,8032888,2022-10-31
c53ea5ad78ba8f60,t-mobile,500309961,20429911,231738,75561,521047171,2022-10-31
0c6e228956280478,mint,437537356,34704907,1130305,77189,473449757,2022-10-31
d379c209fd2790c0,mint,810088766,53166850,104,104,863255824,2022-10-31
9806af63d74c1041,home,601127421,75211501,0,0,676338922,2022-10-31
5a47c42472cd6917,,278556484,9154896,119663,33104,287864147,2022-10-31
2dadc60f3616c51b,,145775798,1784275,0,0,147560073,2022-10-31
4743d9678513d950,t-mobile,409381194,35023434,132,142,444404902,2022-10-31
e8fe86cfeaba05cc,,436013041,25242808,27291,8188,461291328,2022-10-31
07488a9f656ef35f,,46726657,2026232,0,0,48752889,2022-10-31
2481a5f056510d22,,35621341,6009944,0,0,41631285,2022-10-31
97a34de0475794ae,t-mobile,383382272,28269487,2530774,270101,414452634,2022-10-31
4e2ffc794ccfcd3f,mint,92953088,1647953,25638,6720,94633399,2022-10-31
1343222909e102af,at&t,397536270,6264765,0,0,403801035,2022-10-31
35c1e57c163d4c61,mint,809180,232761,1996099,258732,3296772,2022-10-31
a85c8dedbf5ff875,mint,0,0,46663,136343,183006,2022-10-31
5461fcea508671c6,mint,673476565,30183502,837751,97113,704594931,2022-10-31
8a74ab754f812be0,t-mobile,125409384,2148037,116960,138562,127812943,2022-10-31
b26c75d5c9c2022f,red pocket,163621102,13217413,13433,1978,176853926,2022-10-31
8bcd049e3421c3a8,,113487527,5130413,0,0,118617940,2022-10-31
7f90ede873a234c3,mint,341944755,7278983,123489,48112,349395339,2022-10-31
70b68bbb95a383d1,mint,626994802,55011798,132836,636244,682775680,2022-10-31
09d1da35f081d080,mint,645930,174669,41817,12419,874835,2022-10-31
01d72dc26682d482,mint,1132958218,25788850,0,0,1158747068,2022-10-31
d14e1ece4598a441,mint,773677773,35989089,6672,1948,809675482,2022-10-31
e4e73fd896500965,mint,652741716,46085009,4377,1479,698832581,2022-10-31
6a90fcf696d365d3,mint,41451482,8770988,14196,2435,50239101,2022-10-31
df45e2117390daf7,at&t,6409002943,141523080,3004,78011,6550607038,2022-10-31
bb679aa64168b8ba,,1793919001,26598480,55208,16671,1820589360,2022-10-31
8f6d23766dcc93fe,mint,6124973533,132556164,25390,16956,6257572043,2022-10-31
dadc0d70b3bce921,ting,19065068,3297104,164654,83817,22610643,2022-10-31
15a4313a931abf49,mint,398232864,12482017,606388,25374,411346643,2022-10-31
75c2a68359cf81d6,,160985688,3170722,0,0,164156410,2022-10-31
5c28a3ca43a1e5e4,t-mobile,491866775,43571789,78461,23765,535540790,2022-10-31
d7d41b395c4f1b0d,mint,649508814,50591984,14636,3152,700118586,2022-10-31
e3bc648d43425b0a,at&t,368244015,10555148,0,0,378799163,2022-10-31
12cb6eaa419408a1,mint,165895855,26326616,1343570,199576,193765617,2022-10-31
209f3f054d632900,mint,194555148,15719294,232279,78929,210585650,2022-10-31
bd8f2c05794baf03,,451097465,5371125,0,0,456468590,2022-10-31
5b3e70c087ad4036,at&t,765247913,46035107,20823,5949,811309792,2022-10-31
2c1982146ae8d70a,at&t,764832061,51566161,84,84,816398390,2022-10-31
d53cdd414bc08224,t-mobile,207184233,3416240,646254,36561,211283288,2022-10-31
70507e42549c73e5,at&t,620744504,63449770,1293800,116696,685604770,2022-10-31
7384b3fbef0b4d16,Â ,454151751,67986961,20166,4922,522163800,2022-10-31
e5841a3c89c11f27,mint,336723717,16345754,750973,59738,353880182,2022-10-31
30abf15dd613a9a7,mint,1895826732,66425442,26637,6913,1962285724,2022-10-31
c1659c18fcb3f103,at&t,1170918243,91644727,1361054,125524,1264049548,2022-10-31
79228ec960824c85,verizon ,2529784452,81932753,81478,30003,2611828686,2022-10-31
a354af9562b941b3,t-mobile,1315309738,82804107,669530,30422,1398813797,2022-10-31
c09aa98858b0c11b,mint,0,0,656201,25475,681676,2022-10-31
3224affdaaf0ead3,verizon ,0,0,2104802,316065,2420867,2022-10-31
95ede17096595474,mint,232226549,25676813,13339,2030,257918731,2022-10-31
48fabdafc135f6a5,mint,3468360141,101450109,1540922,570168,3571921340,2022-10-31
2e5c27d02980dd3b,,17182967,658324,173831,140761,18155883,2022-10-31
428894ba83cf4e24,mint,0,0,1283030,72382,1355412,2022-10-31
b497a5c8aef0de12,,40623,10810,0,0,51433,2022-10-31
d9e5f648b0443591,mint,691944874,14201343,104,104,706146425,2022-10-31
733822dc9636517e,t-mobile,812590342,28282861,0,0,840873203,2022-10-31
6f593e611ed749ee,mint,68235684,1933178,22643,16731,70208236,2022-10-31
97c7cbc6e798f775,mint,814230867,57887745,7044,2284,872127940,2022-10-31
776bbde22b095684,verizon ,44012,11120,0,0,55132,2022-10-31
638f872155d699d7,mint,309246681,30076845,84,84,339323694,2022-10-31
ad26ffc529f9272c,verizon ,1167554416,64799573,238271,16089,1232608349,2022-10-31
f138ea6194bfcd99,metro by t-mobile,0,0,56468,18501,74969,2022-10-31
59b35f3e98ba3c1c,at&t,0,0,819676,101039,920715,2022-10-31
dbea09c7e2894177,at&t,1705162300,52340116,76378,31943,1757610737,2022-10-31
f4da7e66685d828d,verizon ,560783714,62334350,218984,75752,623412800,2022-10-31
d13a1b051a3bf56a,,707672746,62744810,154593,50895,770623044,2022-10-31
670272707f6de2b5,verizon ,948668193,78520031,15929,5842,1027209995,2022-10-31
02d089fbf64bad35,mint,831357760,77108715,6621,1649,908474745,2022-10-31
172c1787e82347fc,us  mobile,482575,53921,1469704,281710,2287910,2022-10-31
3d7962be99d452ea,at&t,139589549,5965381,1880026,297367,147732323,2022-10-31
bde13d2b6f986a2b,t-mobile,1487534549,100570006,6935,2212,1588113702,2022-10-31
8b2d54d6fc3faef2,,123014457,3248914,0,0,126263371,2022-10-31
66196e86cc8d9a3d,at&t,0,0,143668340,3823322,147491662,2022-10-31
f20049ea19e818bf,mint,656026081,63667127,1670213,207888,721571309,2022-10-31
34cde46ff59246c9, ,761664,215189,616780,180065,1773698,2022-10-31
89768d24408a5851,verizon ,581964957,83875077,51615,13158,665904807,2022-10-31
dc218130fbde59e4,t-mobile,545244059,48778639,101942,28662,594153302,2022-10-31
c955b973390db8a7,cc network,1508366062,74113272,20522,6101,1582505957,2022-10-31
1a3faed78d6b5ae1,verizon ,865318016,61908415,698595,43767,927968793,2022-10-31
4300a73710a00384,t-mobile,374853084,32103801,37274,348309,407342468,2022-10-31
3bb0c5bc4999fd0a,,1105038237,56128343,6733,1889,1161175202,2022-10-31
da710e861a4b034e,verizon ,0,0,849671,251197,1100868,2022-10-31
58a42aa2b018113e,verizon ,326689138,15068565,1250091,241088,343248882,2022-10-31
6208e78c2827b363,verizon ,513457,157320,19305,5694,695776,2022-10-31
43bb8037f2448f3b,spectrum,4105428626,124628847,48068,13585,4230119126,2022-10-31
9897c33e35499bf9,verizon ,491718330,47352413,1031391,52947,540155081,2022-10-31
3a9dcb828ab0aeb2,t-mobile,444055940,56565186,411846,28790,501061762,2022-10-31
601579ba7dd8fa02,t-mobile,352466878,21498803,80142,26887,374072710,2022-10-31
538946d9aa75f8d0,,182872978,1987882,0,0,184860860,2022-10-31
a6d2ac299763be7a,t-mobile,731667620,58086546,806893,84977,790646036,2022-10-31
0e5b9370c6aa6b48,t-mobile,360716260,54045764,316,307,414762647,2022-10-31
d34b99ae66e15931,t-mobile,714616924,75817546,7044,2140,790443654,2022-10-31
8e56f6903eb2dc60,t-mobile,1960526373,55742162,1778015,196480,2018243030,2022-10-31
32b8e5890fdc6236,mint,504757182,24776729,1220810,432665,531187386,2022-10-31
74dc35dac39dce2e,mint,151885252,15233712,0,0,167118964,2022-10-31
6b98f4b9726d9d4b,mint,926551679,64602734,4409,3283,991162105,2022-10-31
e5020475e73eac55,mobile,1302130812,85469756,649844,37868,1388288280,2022-10-31
609693c6dfe45f7f,metro by t-mobile,959892583,82257945,61224,22324,1042234076,2022-10-31
689dd72024e4fb64,mint,741683,248130,0,0,989813,2022-10-31
d36269d0ba5ddee4,ting,811521429,57000812,6672,1948,868530861,2022-10-31
c896c7e887c2d3b3,mint,767419101,46622731,1103449,162213,815307494,2022-10-31
ea5f48aac0729b80,t-mobile,1025782,325207,2179232,755118,4285339,2022-10-31
e9fefda97dccf772,mint,252639141,30958191,25957,7398,283630687,2022-10-31
22da58c30aec07e6,t-mobile,18665856993,167012570,217029,71174,18833157766,2022-10-31
66f404872a37df60,mint,318523994,40471139,1312242,83439,360390814,2022-10-31
3969c5c80d1ce1f8,t-mobile,208157124,7777659,0,0,215934783,2022-10-31
b02cb2e326c4e9f8,mint,313415171,42876561,418,8900,356301050,2022-10-31
03716d1c028c785e,t-mobile,10413276181,194497116,1239853,333701,10609346851,2022-10-31
817e4b8efeaf8f0d,700 mhz public safety broadband,138221168,2764643,0,0,140985811,2022-10-31
5e4635c1ce4d89e8,t-mobile,815700915,28508888,7950,3510,844221263,2022-10-31
2e35873afcd99752,t-mobile,249506747,25574180,351858,128519,275561304,2022-10-31
859c6b9ed98c1ffd,mint,193989819,28646475,34252,11675,222682221,2022-10-31
d4a23629c4215156,mint,898863590,76428427,6565,1876,975300458,2022-10-31
6d07959d43fabf11,mint,14041849,2266998,0,0,16308847,2022-10-31
82b1506e5345090b,mint,54245500,2850103,0,0,57095603,2022-10-31
92527152ca3543ea,tello,953127186,79125371,18893,12148,1032283598,2022-10-31
f8b890d99c3cdc6a,t-mobile,447446799,6699536,0,0,454146335,2022-10-31
d245980982a787b0,mint,526509282,36101391,79283,26917,562716873,2022-10-31
ecac8029bce82618,mint,0,0,29085043,1242538,30327581,2022-10-31
e46829a1052a944a,home,7516,2160,747751,259617,1017044,2022-10-31
5cd3a5f2f008e1cb,mint,1174604549,39049033,18694,11231,1213683507,2022-10-31
831056e0d68ec8af,,166512312,3293175,0,0,169805487,2022-10-31
3d644c66f32eb2a1,t-mobile,337763711,20976836,20709894,790506,380240947,2022-10-31
f6afea6bbd95aefa,,505929,140599,0,0,646528,2022-10-31
377a7361ea89a780,mint,931699721,52768226,1316003,83493,985867443,2022-10-31
3784115d71af7704,mint,761556062,53351075,2319227,709475,817935839,2022-10-31
9cc678bf38bb591c,at&t,734592174,30864850,8485,147650,765613159,2022-10-31
cb7a02fed1ae82e5,,201909,376406,13968,2435,594718,2022-10-31
bdcb3fc31fa6e184,t-mobile,607912618,46281810,151348,74352,654420128,2022-10-31
25acb8244381080c,telus,707230415,63373865,13057,3694,770621031,2022-10-31
9aaaa38d76b842ba,t-mobile,413631729,42105575,935581,137681,456810566,2022-10-31
ce2429fb2979d7b4,mint,653482151,28685295,0,0,682167446,2022-10-31
3f9e8268dbf8ca1d,mint,435784439,54219839,0,0,490004278,2022-10-31
33ad03aada90d3c6,verizon ,546445010,64279153,13235,3326,610740724,2022-10-31
6f6b852e6162753f,mint,784340909,67925574,97706,32046,852396235,2022-10-31
84855b45ad89ff4a,mint,40510591,6831491,903044,118619,48363745,2022-10-31
a38326800116abff,at&t,211136740,22829727,983163,176039,235125669,2022-10-31
5694000b070ae8b8,at&t,1960944312,23086562,650533,22605,1984704012,2022-10-31
9f210946fd674781,,802153,256274,577930,177606,1813963,2022-10-31
85801e4b259f4a00,verizon ,3907130793,77851809,34566,7505,3985024673,2022-10-31
380ceac0f955756f,at&t,196039075,6056921,23021,6316,202125333,2022-10-31
18bb1a93fc8996b0,mint,0,0,1347143,104282,1451425,2022-10-31
ff21d984f1ceb175,verizon ,738135102,82087913,75136,28590,820326741,2022-10-31
b9fbc3357b62cd21,cricket,3311058305,105018072,1174628,202628,3417453633,2022-10-31
5ce90bfc1a24beb3,verizon ,149761719,5635598,878931,104498,156380746,2022-10-31
1c713d302fa798ee,verizon ,287375572,4558253,0,0,291933825,2022-10-31
6fcce091d98adda3,at&t,580909105,59789834,1844233,292307,642835479,2022-10-31
5b10e8474b8a8c9c,at&t,864429344,81633155,0,0,946062499,2022-10-31
a2306ab5c1d91e4b,verizon ,4004930867,91666290,0,0,4096597157,2022-10-31
c90b4b89c1953d6a,at&t,3992218483,112826617,1837843,297878,4107180821,2022-10-31
808c2fcda21f1b33,t-mobile,243809363,8420189,32376,16731,252278659,2022-11-30
6579f7a294135ef9,at&t,1023116005,73699853,79799,29595,1096925252,2022-11-30
7744be06462c146f,at&t,1027871396,22017400,944910,205601,1051039307,2022-11-30
014d1a90a4eeb61e,mint,680683023,62574725,824911,66653,744149312,2022-11-30
248d48704ebcd265,mint,549075008,27732330,827059,146648,577781045,2022-11-30
84428d640a00a236,mint,0,0,862362,90876,953238,2022-11-30
c1beaa37fe76cef7,mint,8213231145,177025553,0,0,8390256698,2022-11-30
bba308c07380bf79,,191753144,2279814,0,0,194032958,2022-11-30
da6e70e36a03191d,at&t,116228719,18216522,272222,80344,134797807,2022-11-30
921a32c23c7c0739,verizon ,559150403,26763566,94610,26166,586034745,2022-11-30
882dba17e6712f6e,verizon ,843858228,57099759,773051,49742,901780780,2022-11-30
d33deb8ec69a7ac2,at&t,0,0,1382548,61607,1444155,2022-11-30
b0180caff170671c,at&t,959080689,66983930,87883,28937,1026181439,2022-11-30
54d31af522bf285e,,47238,208817,0,0,256055,2022-11-30
2da7160c9fb7446d,verizon ,1554697873,81796319,768848,54534,1637317574,2022-11-30
53e74e96f4b73188,mint,681718436,59944479,21618564,351802,763633281,2022-11-30
63885e4d34a5579f,at&t,1036284770,62541493,13537,3720,1098843520,2022-11-30
eccf10052e4c46a9,t-mobile,636045952,37671826,28350,10386,673756514,2022-11-30
57115f6ca24cd938,mint,787422732,52562897,24203,8859,840018691,2022-11-30
6d7c46c032667a68,mint,490796107,15923001,13469,11583,506744160,2022-11-30
f9308eef2a0ef899,mint,903369991,60319817,61701,31427,963782936,2022-11-30
ca6e07f7c22372dd,,152009973,1442958,0,0,153452931,2022-11-30
0244906ae0a183c0,tello,288635521,19851525,919507,68917,309475470,2022-11-30
1a4d9b6687820728,mint,802343674,52218548,956150,278001,855796373,2022-11-30
01e1203050b334be,mint,336124788,43072848,26939,8647,379233222,2022-11-30
c56debffa9d9b7c0,,611306863,16505445,0,0,627812308,2022-11-30
1668aa6f15007b07,mint,770607476,60313356,0,170,830921002,2022-11-30
5b42f781f733ec14,,620315674,61650053,22980,11505,682000212,2022-11-30
9a2bb608900866f3,t-mobile,226488059,101222821,21321376,516271,349548527,2022-11-30
07338c3c94ed8ef2,t-mobile,952444000,75284184,25036,13438,1027766658,2022-11-30
2106ef318b841abd,t-mobile,255829347,25880982,353235,109765,282173329,2022-11-30
d9eaf1d8a362767b,at&t,22205792780,253896138,21652,6479,22459717049,2022-11-30
4f2731b974c41147,mint,717409402,39077938,198003,37772,756723115,2022-11-30
4ecbd862fdf5d06a,,209050276,15942348,76163,351373,225420160,2022-11-30
629d65ec0bf221c2,t-mobile,1191002936,28526079,14088,4568,1219547671,2022-11-30
b273237afda0cc9c,mint,751629783,50589112,14107,7108,802240110,2022-11-30
ed0b51388d5dd1cd,mint,674492752,47747957,151858,73880,722466447,2022-11-30
c66faf29938b3438,mint,1099335353,56058426,720550,55095,1156169424,2022-11-30
a5d28843ecbd34a6,mint,270023225,25039287,0,104,295062616,2022-11-30
4386ca749c649c65,t-mobile,390254079,35316938,206703,16154,425793874,2022-11-30
6d4f09cf9f91e2e4,mint,591424286,28406622,1357751,78300,621266959,2022-11-30
9ffc16256f97b290,mint,825340918,52214783,0,67,877555768,2022-11-30
5cfed0ea6b20cf07,at&t,1510508185,80045855,3287,54483,1590611810,2022-11-30
55512d908807e79c,mint,370138803,39697511,20585,7955,409864854,2022-11-30
67a4601c3ad4cab8,t-mobile,40513719,2033795,2883889,755324,46186727,2022-11-30
ac31c6a14b1f43f3,at&t,4576955008,103019398,930948,90925,4680996279,2022-11-30
84f4c1b5bba404c4,mint,773219372,87551855,81483,37173,860889883,2022-11-30
599adcb8e67824e8,verizon ,863821172,63684348,1641077,1111919,930258516,2022-11-30
a6f5ce08099d674f,,211828002,1876950,0,0,213704952,2022-11-30
b908246821dbd863,at&t,1134840057,77717470,2189983,1155507,1215903017,2022-11-30
4d25c78e42d9d4b0,t-mobile,472949536,10384293,18948,5476,483358253,2022-11-30
733265c0790318de,verizon ,216215,86785,205510,67706,576216,2022-11-30
7948e578a419f012,verizon ,547733857,50133117,27352,7927,597902253,2022-11-30
709b42fd414c7ccc,verizon ,1082896339,104211973,3390862,1140343,1191639517,2022-11-30
d9e070a825685abe,at&t,599386996,45710727,751017,84629,645933369,2022-11-30
2839db60a961ac84,verizon ,2726963616,104046155,98033,35318,2831143122,2022-11-30
5d88e1dd9844a269,t-mobile,632725202,79879954,259079,93426,712957661,2022-11-30
8876bc02e0b5b49f,grameenphone,5732217,1681640,0,0,7413857,2022-11-30
f0533d0cbce85d2e,mint,1460867283,89576716,2014488,250285,1552708772,2022-11-30
2f6a5ac4569d9fe1,verizon ,538819499,67767278,1016268,145903,607748948,2022-11-30
1ecfd23fb0deb5ab,verizon ,902673352,53754078,69340,23255,956520025,2022-11-30
438007b14e919a4d,verizon ,663420564,60067720,117240,37751,723643275,2022-11-30
29975ab77ebec6ba,mint,0,0,2674534,1003360,3677894,2022-11-30
814bcb8dc428b6fb,t-mobile,422784921,61203585,2132086,459703,486580295,2022-11-30
b598f55383cdcefe,robi,772750721,28761994,897,16226,801529838,2022-11-30
194673c7bd32ce30,,484281238,28264146,6935,2212,512554531,2022-11-30
75801bab5e1e0b38,t-mobile,283075601,25817392,128238,1395680,310416911,2022-11-30
3a242382631a3da9,t-mobile,563111548,46265625,254535,36353,609668061,2022-11-30
cf1cb2ad3dff554e,mint,142784698,12065002,20610525,725642,176185867,2022-11-30
288f10535e0cc04a,t-mobile,534122429,61573709,35735,18478,595750351,2022-11-30
c27bf052d83df2b8,t-mobile,777060546,50891235,28259,5705,827985745,2022-11-30
05d1ac189b5b96c7,t-mobile,743573978,52934994,789045,56927,797354944,2022-11-30
ee4e8d5ee8f7d248,mint,19163761,3180568,1435326,106586,23886241,2022-11-30
f5f590c446b98c01,mint,848651727,68643174,359988,33772,917688661,2022-11-30
f8f7df88e06ff6a3,t-mobile,0,0,724556,72334,796890,2022-11-30
373e16d7d6b5d9c7,mint,797764211,75104772,20808,7932,872897723,2022-11-30
505bd09478392631,t-mobile,702823246,52655672,7153,2296,755488367,2022-11-30
5c388aa7f853478b,at&t,879233541,56186112,565670,40459,936025782,2022-11-30
15945e971b35fc2b,cricket,101497138,5306452,1235969,99164,108138723,2022-11-30
42a4dd10029ff4a1,at&t,787019052,51122195,733857,61098,838936202,2022-11-30
0a2404f90a69d332,cricket,0,0,1143868,199053,1342921,2022-11-30
58c3f0493a7199f8,t-mobile,860927788,58954651,0,0,919882439,2022-11-30
3af3623de516ccab,verizon ,637458328,52910038,84,84,690368534,2022-11-30
a8fb280d1bdcfb45,at&t,837062553,66283221,717207,84510,904147491,2022-11-30
71b190e74bdebb73,verizon ,750454852,57429094,48196,17594,807949736,2022-11-30
f27438a1db32cda1,,861747145,40970451,713510,53854,903484960,2022-11-30
1e6f4e06807257ba,mint,272796726,22576769,732475,62525,296168495,2022-11-30
1ee6f17823fb3172,Â ,1504886735,41068621,1027859,161552,1547144767,2022-11-30
37e6769f95c3c533,t-mobile,817951400,38982555,1453633,293722,858681310,2022-11-30
667917e2eef78ff9,verizon ,670123745,66824587,20849792,403960,758202084,2022-11-30
fbfa963a6e3846c7,,124881427,3117182,0,0,127998609,2022-11-30
26fd8e3c19c53ac9,mint,989098008,61284467,2034783,289001,1052706259,2022-11-30
638fc1e920609641,verizon ,719487844,22929513,145540,51500,742614397,2022-11-30
2f1773a2620a525d,gsma,664882055,31580898,1429204,108659,698000816,2022-11-30
b8367f4b55ab322f,,231897054,3629456,0,0,235526510,2022-11-30
5486e1ec26bf3b44,t-mobile,954192473,86338407,704437,38129,1041273446,2022-11-30
71fc2f5e35b2b82a,mint,542804909,42978810,765604,77294,586626617,2022-11-30
4b319d8658327d97,mint,1022553369,72243708,769317,49857,1095616251,2022-11-30
efc3b95dd2ac1dba,mint,420721246,94665116,168,168,515386698,2022-11-30
dd8a35579919fa49,,190846202,7890605,0,0,198736807,2022-11-30
1f570e119ce2e0eb,mint,735201123,64361655,692563,24033,800279374,2022-11-30
72a6848dd8d05bbf,at&t,780079434,64926983,97282,42125,845145824,2022-11-30
c0ef3b237fcf5c26,t-mobile,536544534,32153270,1225833,218334,570141971,2022-11-30
3c2dce7ab5050262,,438325632,55171118,680779,25118,494202647,2022-11-30
a84cecd13da37ce4,verizon ,669914824,61175112,733986,44066,731867988,2022-11-30
30e2cb8cb00cebc5,,267604151,28587172,0,300,296191623,2022-11-30
02b86706967e7bdc,verizon ,246822490,23121738,21278019,1232495,292454742,2022-11-30
3afc651b4655e812,t-mobile,1316519593,78400048,1156260,295003,1396370904,2022-11-30
bdb4f2ac9103b0b0,mint,701267730,59592875,22143350,1138592,784142547,2022-11-30
3cc1bf9d1b4f6bf2,verizon ,909394999,51720036,1019843,142065,962276943,2022-11-30
96d972b4531ded6e,verizon ,1582875246,74094711,1016655,150517,1658137129,2022-11-30
215b6dd7ba4b0b62,mint,699997443,75017456,1002790,139845,776157534,2022-11-30
ebb1a89d6921b915,verizon ,954737819,55495691,71052,22392,1010326954,2022-11-30
0f531fff2ac6e322,verizon ,1744,2436,1841641,209358,2055179,2022-11-30
213146cbc59aa060,verizon ,445789107,64684149,294969,98293,510866518,2022-11-30
709e2f81d7bbb4b2,at&t,0,0,29926839,604437,30531276,2022-11-30
6781105bc01b385e,t-mobile,850181435,94901380,20772381,532129,966387325,2022-11-30
d75c8261646e8e67,,71132393,3106887,0,0,74239280,2022-11-30
26406baa18eecee7,mint,904086026,76131138,16306,7783,980241253,2022-11-30
527a0f19dbe6d1fa,mint,444334615,35839319,55937,24494,480254365,2022-11-30
f2d81e2aac0d499d,mint,448297887,42611053,179473,72259,491160672,2022-11-30
c1e59c2ab2fd2041,mint,895625562,68998282,29351,10247,964663442,2022-11-30
7cb10bfb361111dc,t-mobile,990861432,74898087,23326,7256,1065790101,2022-11-30
59b707bc1ac9e8fb,t-mobile,417271055,54903402,70721,145528,472390706,2022-11-30
54bb43618efa7836,mint,560547697,61158284,767597,87641,622561219,2022-11-30
9184fe91d8998d62,mint,774764737,55505179,247,102,830270265,2022-11-30
f3c9d6706ed9170e,mint,568988917,63314289,0,55,632303261,2022-11-30
753c51391bf5a866,mint,637404910,51525770,362273,49548,689342501,2022-11-30
9e372ff594b347a2,verizon ,789820695,47499576,15411,5091,837340773,2022-11-30
0c6f4f17447a65fa,tello,638639289,57335380,758547,65906,696799122,2022-11-30
409bb569c9ca0d50,mint,4906790844,122521309,110062,36424,5029458639,2022-11-30
d4b0f03de699c34c,mint,877878421,42576906,6935,2140,920464402,2022-11-30
0416542456bb986c,mint,479659904,44168512,1400176,98512,525327104,2022-11-30
ec22684d02b3abc9,,149222077,3576581,0,0,152798658,2022-11-30
286b539223b93de3,mint,1505601013,82925452,104,104,1588526673,2022-11-30
75e0da9d95c70569,at&t,1010152925,62472239,6796,1545,1072633505,2022-11-30
9fb958203f7658e2,,129682868,10084646,0,0,139767514,2022-11-30
6665b46267459c84,,170544120,4018135,0,0,174562255,2022-11-30
b5440d66f170cee5,mint,712711085,59126525,7042,2296,771846948,2022-11-30
3211a0128d0f6a6e,mint,3979906726,25984454,6493,1535,4005899208,2022-11-30
3d08af4071ca91ac,at&t,372666024,56592172,903320,115727,430277243,2022-11-30
02dfc556c81dba21,t-mobile,714846709,70896129,3797,78099,785824734,2022-11-30
87169c4bd84083fa,verizon ,28984563518,181481464,22280066,966847,29189291895,2022-11-30
fb1421cecde43ac1,mint,3911647450,92922600,819732,135789,4005525571,2022-11-30
deb5eb77bf850be9,t-mobile,1536882412,67538261,1945501,445404,1606811578,2022-11-30
1f3d1b284fe55ce9,,186173897,2362206,0,0,188536103,2022-11-30
563c0880af8fc454,t-mobile,789116879,101870453,1460658,305252,892753242,2022-11-30
6a553c96bbac1494,mint,121731155,3766763,2613576,446391,128557885,2022-11-30
11355e84b69e3f35,,104612007,3889775,0,0,108501782,2022-11-30
28d1708976fcc040,t-mobile,383141757,41847022,36204,13912,425038895,2022-11-30
84e0bc2840998846,verizon ,361924613,36248100,17028,10715,398200456,2022-11-30
6c8ed7111901396b,,850651872,72111680,6522,1564,922771638,2022-11-30
6d6a3630fd047ffd,at&t,1004412124,57686446,84,0,1062098654,2022-11-30
c0f955b06107c6d2,verizon ,1042388360,80183719,1962535,262937,1124797551,2022-11-30
5bfbc9740fc2ec3c,mint,399746877,15071541,559088,55316,415432822,2022-11-30
44a872f2861167c0,mint,1179626846,29654787,107504,40751,1209429888,2022-11-30
d94d988b39dea9af,mint,498764411,24733562,20572329,795093,544865395,2022-11-30
c69529487f4ad7f0,us mobile,1783005534,81575616,996,7580,1864589726,2022-11-30
033b181795b892a3,,162383059,2845528,0,0,165228587,2022-11-30
5830f994ce79987f,,109776282,2268956,0,0,112045238,2022-11-30
d49c8fb8a401b18c,,162309080,2268242,0,0,164577322,2022-11-30
6e2d038e1d8856d0,mint,116817113,5751652,6863,2033,122577661,2022-11-30
3aba0ab17c7a658a,mint,496130156,21091734,10254,82074,517314218,2022-11-30
2b8e16f2e83ff904,at&t,560771599,61313831,686192,13907,622785529,2022-11-30
f256a0e02c8b464e,,240586767,3540858,0,0,244127625,2022-11-30
f3b166562548c2ce,truconnect,4024029151,91403757,1733867,307770,4117474545,2022-11-30
0128b67fde55501e,emergency calls only,974645769,47870532,6368,1741,1022524410,2022-11-30
b138215797c500d8,at&t,191717554,24824918,897081,122506,217562059,2022-11-30
9e49fcb44ceb7ddc,verizon ,707638,228144,2675843,536185,4147810,2022-11-30
a98ecfed194af6b1,t-mobile,1013199843,100293348,937724,111951,1114542866,2022-11-30
0c3495c74d57b7b3,verizon ,504807030,49218504,1379940,71537,555477011,2022-11-30
dfc0e5a8acc04f0a,t-mobile,1237102456,79481180,57576,18474,1316659686,2022-11-30
a88ccaa2b8b2efc5,globe,383612410,6545697,0,0,390158107,2022-11-30
9cf69bfb1c53de86,,155214309,2166262,0,0,157380571,2022-11-30
a5dbd89c0a60ceda,,154665733,1816891,0,0,156482624,2022-11-30
9daacc582c4f150e,,154353425,2289173,0,0,156642598,2022-11-30
343a566b1e735888,,154642986,1730626,0,0,156373612,2022-11-30
b5fc1c4d03a3cf43,,154447635,1994917,0,0,156442552,2022-11-30
47b0060e90c83708,mint,1751426502,48096731,1452674,130982,1801106889,2022-11-30
d9939f03a38bfd8f,mint,2216478642,49075643,749320,65437,2266369042,2022-11-30
ae09f06ca4ed0250,mint,733195662,17023894,45706,16123,750281385,2022-11-30
dbaf7a481962fd41,at&t,276657494,13609803,84,84,290267465,2022-11-30
9ed3b9eacb4d6165,verizon ,68987894,4103753,1394937,97510,74584094,2022-11-30
b93d1b941af991e0,,163675384,4527622,0,0,168203006,2022-11-30
9dd0eeb578e620c6,at&t,6181223049,87769599,1226809,287778,6270507235,2022-11-30
ed5f28b70f26dcfe,t-mobile,642891354,41317391,1428110,86779,685723634,2022-11-30
ac8cd0ce9916528a,at&t,792107503,34246898,68367,30193,826452961,2022-11-30
a4a3b00c8abe8a0e,verizon ,2538538740,94074485,51076,22108,2632686409,2022-11-30
0719047811651ec5,globe telecom-ph,411730539,8410972,0,0,420141511,2022-11-30
3f09b8db694325c5,mint,236509508,27956207,33622,18063,264517400,2022-11-30
bd3f5422f69136bb,mint,422941238,40359549,711253,42060,464054100,2022-11-30
7dbb61d75728f119,,110801820,2495415,0,0,113297235,2022-11-30
350fe1e8208411a7,,80763396,1823666,0,0,82587062,2022-11-30
b5f8ff7877d692df,,428893519,2767405,0,0,431660924,2022-11-30
c6cf01a96fb00743,,170772812,2504112,0,0,173276924,2022-11-30
2828d28317a90ae6,,179274753,1502184,0,0,180776937,2022-11-30
c7c377261a466ab3,,84689991,2053952,0,0,86743943,2022-11-30
4224a9b396da0981,,389554278,4190541,0,0,393744819,2022-11-30
507c5ee7a6016ba8,,321971664,4935748,0,0,326907412,2022-11-30
11f65bcdc15a5a24,,129140768,5467043,0,0,134607811,2022-11-30
6bccfe72616059c0,,179530622,4471111,0,0,184001733,2022-10-31
a234fca9b0c9e118,at&t,454725613,57674268,20215,4594,512424690,2022-10-31
ec8b62f5590ebec5,verizon ,606649948,63063298,6419,1289,669720954,2022-10-31
245e8919990cc2dd,verizon ,1953415460,38899973,140541,49336,1992505310,2022-10-31
36e358c99f9975b7,mint,5013110425,126450670,1534498,153891,5141249484,2022-10-31
27795820a5892b20,verizon ,713907252,71949157,1054165,168752,787079326,2022-10-31
a0a7d254eeff6b31,verizon ,711630012,58868034,6661,1689,770506396,2022-10-31
546d809b6b15135c,t-mobile,666732513,56884801,9135,3412,723629861,2022-10-31
0743dc87d72ae683,Â ,1309098378,82533449,0,6770,1391638597,2022-10-31
0f904ae824143a81,t-mobile,514371658,44931841,17699,6567,559327765,2022-10-31
b046936e75eb4478,cc network,0,0,139520339,3439051,142959390,2022-10-31
ad3f01a040066b7a,t-mobile,761823885,35931982,1977978,518718,800252563,2022-10-31
a868decfaf0a42f8,verizon ,624061215,65736953,20797,6630,689825595,2022-10-31
e43b90da1f404590,spectrum,39009785,2553595,1280773,62157,42906310,2022-10-31
193ec5f674331475,mint,1037840558,50838623,0,0,1088679181,2022-10-31
406d73e01974753c,mint,0,0,27847009,521818,28368827,2022-10-31
126e2e0dc2fe029d,,170103011,4860686,0,0,174963697,2022-10-31
ce03f47d689440fe,tello,44644,12115,750254,222437,1029450,2022-10-31
24bf181d97eca657,,397821296,26715966,14193,4880,424556335,2022-10-31
dffbc3c3b4817b15,,122216516,8028358,6943,2497,130254314,2022-10-31
1e95cea6e80d203c,,33339,9105,0,0,42444,2022-10-31
7bb4dd0996fe9a9e,mint,14645716,2386983,0,0,17032699,2022-10-31
d3156623c18a0697,mint,813326731,62932188,938708,143674,877341301,2022-10-31
272ebc122d617a03,mint,315199472,35766150,37933,13286,351016841,2022-10-31
ce8bf770d7d4f8ba,mint,0,0,36125,8141,44266,2022-10-31
2106a774d9fcb172,t-mobile,459713143,45192011,681312,53703,505640169,2022-10-31
2431ea6ca3b590dc,mint,1080826916,22755520,7033,10962,1103600431,2022-10-31
9e9050aecaee1a96,mint,1385280012,112005895,1036357,191821,1498514085,2022-10-31
368e77fbedd6a5da,mint,481193190,39554312,1349586,103660,522200748,2022-10-31
ff1b5b8619b00e49,mint,2107994882,41129918,16352,5455,2149146607,2022-10-31
faa298aee9fc17e0,,1387060,207084,0,0,1594144,2022-10-31
02caa462b14d3e4f,t-mobile,818011972,78224767,600408,79360,896916507,2022-10-31
d8a2ba7475fd8698,,118706415,2623550,0,0,121329965,2022-10-31
5856ec48d3acfd4f,mint,434530844,7068131,52,0,441599027,2022-10-31
8d0684dd18061970,t-mobile,822946682,14433939,0,0,837380621,2022-10-31
c967b27cad9acce6,,223545232,4409538,0,0,227954770,2022-10-31
9c811b290c8a45f8,,192037735,3920795,0,0,195958530,2022-10-31
df11dce03d272d67,jio,496526534,26181673,14210,4950,522727367,2022-10-31
6edd7e3c2be4aaec,mint,149031574,2419105,40073254,1402734,192926667,2022-10-31
5570e0ed36c47fc0,mint,832102657,61221433,6672,1732,893332494,2022-10-31
bd32ca71125a9bde,cc network,0,0,632203,82449,714652,2022-10-31
ca83106da616bc2e,mint,561384216,55045428,104,0,616429748,2022-10-31
d5a9662354099805,mint,935248199,50673989,104,104,985922396,2022-10-31
3ff301cf954b3832,,320115,1103528,0,0,1423643,2022-10-31
e85a185c620743ef,,48086580,9369200,0,0,57455780,2022-10-31
78d33c0fefa44b2d,at&t,799541023,33082113,664723,48109,833335968,2022-10-31
4aa8b7fa97dc87b8,at&t,1624824049,79379132,1909546,196742,1706309469,2022-10-31
2a951786f4090dd4,verizon ,417456436,40195299,33966,17527,457703228,2022-10-31
7226182d81b245cf,verizon ,0,0,1330244,96794,1427038,2022-10-31
a0a866c5e0347a22,verizon ,930657298,76333866,182242,79539,1007252945,2022-10-31
87cc8c90edd6e7b1,verizon ,741761621,73089508,953376,126011,815930516,2022-10-31
4a507f2a55bcf7fb,at&t,0,0,26141,7664,33805,2022-10-31
28ab70f09d8fe115,mint,756937077,37056651,662318,33536,794689582,2022-10-31
35a117dc94709b9d,,102402124,2276806,0,0,104678930,2022-10-31
f737b5e1bcbfce88,,110747983,3795626,0,0,114543609,2022-10-31
bececdea43fb0920,,155572528,1371264,0,0,156943792,2022-10-31
58f9a370c93c52ff,mint,783851608,30434129,104,104,814285945,2022-10-31
b4c137f4d9ed38cf,,250273849,3265183,0,0,253539032,2022-10-31
c80a39c3cdf9a809,mint,625861554,49155796,119945,53461,675190756,2022-10-31
391e933e58957ede,tello,254444663,23693037,1622821,235478,279995999,2022-10-31
f962717e6c912dfc,,991881472,50507964,208,208,1042389852,2022-10-31
87ddae1aded4a92c,mint,219039139,2564607,1062187,78690,222744623,2022-10-31
7d723d140393ab1e,t-mobile,593078072,49553440,15404,4726,642651642,2022-10-31
1aeb4034218bd443,mint,569585373,13350323,708427,83534,583727657,2022-10-31
1d0460060da4f2c3,at&t,663811526,50883125,0,0,714694651,2022-10-31
42587399d4443c2b,t-mobile,983239410,48492429,1469,1105,1031734413,2022-10-31
d87efba6cdb9e684,,145285680,3038571,0,0,148324251,2022-10-31
3a60d7a35fc94739,,278452002,32706915,0,0,311158917,2022-10-31
f655711736c4a99e,mint,1203335752,76151363,1717095,336058,1281540268,2022-10-31
ca0a8a10f18e3fbe,t-mobile,66158168,7989165,498,4687,74152518,2022-10-31
311bc8bb49f39a87,mint,717602831,67636767,20085,5617,785265300,2022-10-31
7c72c8c4300455db,t-mobile,647046555,18811076,547538,34723,666439892,2022-10-31
67ebb2bb9e85e498,t-mobile,0,0,36444,7562,44006,2022-10-31
d168a9ee2452debe,at&t,634283446,41629461,13220,3722,675929849,2022-10-31
efef5b1adfd23622,,1014981264,46874694,13536,7336,1061876830,2022-10-31
0a2a259f068a7ffa,,17197822,1699588,0,0,18897410,2022-10-31
8967b8a4d3bfcf86,home,560338273,49416475,27422,17767,609799937,2022-10-31
8ba2c88235bb9616,mint,1978668759,62054285,1876368,305958,2042905370,2022-10-31
2875e7869a0edcc5,mint,113841711,6037708,576221,50136,120505776,2022-10-31
5aa8475f92544bd5,mint,342359826,38208141,6935,2284,380577186,2022-10-31
0b1f0b1e6e731420,at&t,449668218,41861302,724677,46359,492300556,2022-10-31
0a1251d15fcc5140,mint,3931303969,104244348,1624664,165195,4037338176,2022-10-31
1407d990dd45d05c,at&t,1399193296,62220722,1334790,243896,1462992704,2022-10-31
82aca34de255bf29,mint,730533278,68271311,2003493,275197,801083279,2022-10-31
0c5c079c40a62554,at&t,37738117,2748394,2705882,1130625,44323018,2022-10-31
8c8d7eac099b5da4,at&t,701929890,44965010,1864454,249436,749008790,2022-10-31
b255331ac3794234,at&t,423532239,42530169,796145,109278,466967831,2022-10-31
b06f87a1d9304527,t-mobile,1560875977,83970314,241122,106930,1645194343,2022-10-31
42482f81821c6f16,mint,505672500,63765761,215596,91978,569745835,2022-10-31
5917a253b150864c,verizon ,900597191,49593826,651737,35614,950878368,2022-10-31
d75aa094d09d8544,t-mobile,17645279,3077703,1757671,242261,22722914,2022-10-31
3b961ecffa64c0bd,verizon ,180883169,24019795,1332047,64529,206299540,2022-10-31
218b765448f20941,at&t,384017844,39446442,90442,44830,423599558,2022-10-31
42f0d4321ab1d837,mint,1328186541,91726090,604216,10059,1420526906,2022-10-31
c973750a5e8d35bb,verizon ,42821293,2652269,1128278,208291,46810131,2022-10-31
2bd3551aea345298,mint,1235562244,71192670,6621,1701,1306763236,2022-10-31
876491f2afd8d2fa,mint,372516038,32739394,84,84,405255600,2022-10-31
c09bc5a323287276,verizon ,473589453,49550248,665817,621012,524426530,2022-10-31
1fc12d01545c8862,mint,483324161,42460279,72635,35051,525892126,2022-10-31
ac106ba40e906151,verizon ,1563184556,55139732,1878716,257786,1620460790,2022-10-31
20ba98062208e004,mint,770810932,79116402,920122,246502,851093958,2022-10-31
2e27c88d489b5530,pure talk,98449,75725,485766,74560,734500,2022-10-31
f7ae35e3679e2a1c,verizon ,619312892,59146349,8238,4548,678472027,2022-10-31
8fef9cfc284b7696,at&t,872964044,77231477,716408,57309,950969238,2022-10-31
fd16bab9655e3a66,mint,1346649787,93706584,1085626,168723,1441610720,2022-10-31
184474384b8d34e9,verizon ,2016754312,116127639,14857,4200,2132901008,2022-10-31
3ee83fca75f11f2c,,21781,6169,0,42574,70524,2022-10-31
8f9923b99821d957,mint,1162604343,13721471,227,170,1176326211,2022-10-31
aef89b17232ff76b,verizon ,561292936,38560868,646028,237566,600737398,2022-10-31
c6635f598f995547,verizon ,921626671,50894470,84,84,972521309,2022-10-31
e90c50c0aa9dbfad,verizon ,705749433,67403443,0,0,773152876,2022-10-31
4a7fc570fcf5f032,mint,308695784,12214891,578887,45814,321535376,2022-10-31
110ad06f28a286ee,at&t,254260605,15160858,1937242,278751,271637456,2022-10-31
6c5256a387d49ead,verizon ,624315203,73507861,1474569,136430,699434063,2022-10-31
59b24a7364354b8f,home,568481316,55105304,169594,65529,623821743,2022-10-31
189892a3faf51f09,at&t,586705482,73868794,1320873,116577,662011726,2022-10-31
07d1103eddfc278d,mint,379616452,42249033,2392920,384735,424643140,2022-10-31
6cf1ebfbc68821dc,verizon ,1818273293,66752185,1063696,164535,1886253709,2022-10-31
58fcdcf5c2ec47d7,t-mobile,543044787,64145389,980166,151084,608321426,2022-10-31
932f325bdb4f5a9a,verizon ,403094597,38263742,1297405,67809,442723553,2022-10-31
47a85c07881b8737,t-mobile,1157913840,83876344,0,0,1241790184,2022-10-31
61718ef13bc18e6c,mint,591395189,61464978,6853,2199,652869219,2022-10-31
e05bc83313fec9c6,mint,500496308,23685491,165208,63846,524410853,2022-10-31
8c6e31959819d12e,mint,435096069,14220068,90870,36920,449443927,2022-10-31
18ab7f8cd82f54d1,patriot,429317971,36021520,29595,10351,465379437,2022-10-31
5fcc57293c6f0fb3,mint,413797196,20368218,80,911,434166405,2022-10-31
ab1d2bed7079ae16,t-mobile,572016813,26397048,632639,28468,599074968,2022-10-31
dd7c12334b29c479,,342689880,6465741,0,0,349155621,2022-10-31
36d734b8f3c12578,mint,817469574,34568203,34792,8301,852080870,2022-10-31
064f259b06a8109d,mint,31591245,6747446,185050,83988,38607729,2022-10-31
09353c03aa3aeaab,mint,378977353,14417226,60559,15172,393470310,2022-10-31
c3f21323bb7ba32f,,473232,95414,8901,5213,582760,2022-10-31
ec6ae2a16c81824b,mint,1729604768,39590588,40734,12470,1769248560,2022-10-31
d8befafd143abf61,mint,0,0,33617,8226,41843,2022-10-31
080464d68aee041e,t-mobile,0,0,1015360,149506,1164866,2022-10-31
e9f3b998eaead599,t-mobile,802893458,70333321,68584,22734,873318097,2022-10-31
b08cfa927fe4e1f2,,242509502,6221332,0,0,248730834,2022-10-31
f6ce3c34a6fe8744,,255267170,5607982,0,0,260875152,2022-10-31
720959d5697a1de6,mint,643529968,20595506,811043,96483,665033000,2022-10-31
79de0c665e8950bd,mint,817909,225002,141376,52794,1237081,2022-10-31
3abae2eac7dabf17,mint,108937015,14971101,31679,23048,123962843,2022-10-31
fbc5cbeec2a0c616,mint,965378341,63651257,129872,40934,1029200404,2022-10-31
58697734c11a4943,mint,931047448,49686542,1389168,221229,982344387,2022-10-31
a72727853f0191fe,mint,602872195,55331019,8353,2224,658213791,2022-10-31
64aa880bdeba9f23,mint,833173318,65516293,14062,4723,898708396,2022-10-31
238ad07647679370,verizon ,666738675,67312418,1260460,326434,735637987,2022-10-31
00e45cc088309c73,verizon ,630876964,44774788,29907,15661,675697320,2022-10-31
d1e3ab95f45b8d91,verizon ,496511409,57323771,35615,11865,553882660,2022-10-31
20f8be3d5198e9bc,mint,922325059,67604210,6621,1701,989937591,2022-10-31
489f7a0c55a0a5fb,verizon ,773008173,67375418,34471,9759,840427821,2022-10-31
62755f00551e6d96,mint,1517838451,95792593,1716608,393787,1615741439,2022-10-31
2dcd0390173e9192,verizon ,3021662118,103994480,805840,77594,3126540032,2022-10-31
f5456260134277eb,verizon ,553632706,54869083,874921,90025,609466735,2022-10-31
902e1f0934fa5f2a,t-mobile,4432592100,115343406,31370,16854,4547983730,2022-10-31
b9e4b1e1058c47fd,t-mobile,727013600,53289089,1367326,287675,781957690,2022-10-31
a3341e6ea9615dcc,verizon ,652557639,41657913,84,84,694215720,2022-10-31
69901a423c3a4473,,148458668,2536876,0,0,150995544,2022-10-31
961e553a7c762f8d,mint,697227490,28095365,1680376,219587,727222818,2022-10-31
f8fe1bf396a78b12,at&t,0,0,1319471,74563,1394034,2022-10-31
f37843ebbb895033,ting,541830510,45824741,708533,41923,588405707,2022-10-31
b7bdfa52210e414d,mint,921657987,45449567,346563,133299,967587416,2022-10-31
14c438c852a3f7f6,t-mobile,778965566,27808366,1344347,93790,808212069,2022-10-31
5f9e205fdc0ca7e7,at&t,80346842,9448295,1702310,269701,91767148,2022-10-31
dc3a3fdf33969f13,at&t,543726823,52324497,84,84,596051488,2022-10-31
5591f6dec1e648b9,mint,723482488,46383593,680116,59956,770606153,2022-10-31
9a10f620f4e8c4d7,at&t,230805704,19735284,1322316,52118,251915422,2022-10-31
9dd28e17ba92874b,,189192011,3927000,0,0,193119011,2022-10-31
65ba860e1c80d80c,mint,441798324,26939525,273622,23562,469035033,2022-10-31
3384cb20e64037a2,t-mobile,1854232433,39943455,6935,2284,1894185107,2022-10-31
e7a54582a3143156,mint,1210291196,45376044,6935,2284,1255676459,2022-10-31
91e5234b25e4f286,,230517215,22159480,0,0,252676695,2022-10-31
37cc23f22243f626,metro by t-mobile,195832028,14318396,227,170,210150821,2022-10-31
3411a67f9a41f5a9,mint,1134108209,71185559,104,104,1205293976,2022-10-31
c3181d90c26606b8,mint,1190543610,56582680,14098,3872,1247144260,2022-10-31
cfd8f13e4885e082,red pocket,670513885,76123335,57706,15866,746710792,2022-10-31
98af524a662bb52e,mint,1350671860,66737855,1894443,325646,1419629804,2022-10-31
14206b01430c73ce,mint,1483449168,47835113,668640,29092,1531982013,2022-10-31
7e166d5639a849e5,mint,934682128,46211173,681218,66952,981641471,2022-10-31
a9885d049f59e758,t-mobile,6997129010,89868612,26346,12269,7087036237,2022-10-31
efc33d1b6ee53550,mint,807518404,53984443,656572,56816,862216235,2022-10-31
0773c953cb99f0db,at&t,731078674,53758347,203523,72034,785112578,2022-10-31
52b569e21649f758,at&t,974859797,68094168,0,0,1042953965,2022-10-31
3f864c6a66bc042a,mint,1213585481,65850131,219893,79587,1279735092,2022-10-31
b1c673322f3c59c1,cricket,702494757,77292553,39503,10382,779837195,2022-10-31
5c5400e556e3d586,mint,1140263273,49282242,27948,8721,1189582184,2022-10-31
9b5173a70f491863,verizon ,801890212,94124992,6601,1172,896022977,2022-10-31
49307a52ad189667,,124268352,3352308,0,0,127620660,2022-10-31
c96531f1ceaf60d6,,389084929,38095241,0,0,427180170,2022-10-31
a8045fdbdffe7168,t-mobile,2159301300,68146923,1015727,62623,2228526573,2022-10-31
4ff59358f8c49840,verizon ,511491122,67248769,84,84,578740059,2022-10-31
dd30b8a0e9bb9b03,mint,940361554,25032755,650143,36677,966081129,2022-10-31
9a6d985af9328463,at&t,1318987174,66798156,771546,64154,1386621030,2022-10-31
ea860a2d2447734d,t-mobile,0,0,2401758,445677,2847435,2022-10-31
c82d4107e12ebf95,t-mobile,564875043,46561823,1215113,274481,612926460,2022-10-31
ed79f431c2332559,verizon ,576844560,61222304,2250,850,638069964,2022-10-31
ff3830a844a05007,cricket,566607443,48091088,2033124,290228,617021883,2022-10-31
65a96bfbb746b39d,cricket,683273766,17381267,10803,5677,700671513,2022-10-31
3819ab146562c5ca,verizon ,545186853,57594427,184747,62581,603028608,2022-10-31
fd97c68bff6af191,verizon ,928769379,30889853,2005090,275666,961939988,2022-10-31
daf11b5154b8cec8,,506004,206071,0,0,712075,2022-10-31
7bb22b229cb77693,t-mobile,681175312,50955824,678124,43465,732852725,2022-10-31
0adf801ac3b4b648,mint,882102903,67290869,700127,46631,950140530,2022-10-31
8be13f84d1431d84,at&t,602795674,50549048,610124,17233,653972079,2022-10-31
261e5e3d1ad9dc1a,t-mobile,481415117,45383469,887437,122672,527808695,2022-10-31
f9b2da8217903d78,,5534816,673664,0,0,6208480,2022-10-31
2c679da59e82ffe8,metro by t-mobile,926060877,59925998,650111,35156,986672142,2022-10-31
9ff4eb664d6b3288,mint,4484650644,114323856,104,104,4598974708,2022-10-31
b16e08dd0f65612a,mint,641172920,56619927,869294,124099,698786240,2022-10-31
f4d84d891ca76744,mint,0,0,1302347,85914,1388261,2022-10-31
5fedebd4d2435515,mint,861765548,53555940,104,104,915321696,2022-10-31
39f21e278e43c449,mint,692792115,58328121,6935,2284,751129455,2022-10-31
18b0fbabebcfafd8,mint,983220638,72515873,7044,2356,1055745911,2022-10-31
65533c8bcb41d72f,mint,124978541,13170312,104,104,138149061,2022-10-31
63377bc94a568cee,at&t,417535466,39825316,13814,1884,457376480,2022-10-31
e6dd5806a61f31fc,mint,374061511,17036357,1333497,79517,392510882,2022-10-31
208a347440a2356b,mint,3535380268,73999547,768448,93192,3610241455,2022-10-31
1900939fb02ce91d,mint,2507955372,62109065,425612,185762,2570675811,2022-10-31
0abed4091d45b041,t-mobile,580245448,52195785,898298,121166,633460697,2022-10-31
ad1b4fafe01e6196,at&t,754575811,60175236,639237,22425,815412709,2022-10-31
05a680d78ca0e5bf,verizon ,264091734,15615804,1186517,197043,281091098,2022-10-31
1c0c83cc251664c0,verizon ,1155136950,74121083,27460,8581,1229294074,2022-10-31
797857d4cacefc99,,2763948240,55921567,1006263,196637,2821072707,2022-10-31
c0c7c65ed03d376c,verizon ,507181401,66324095,13812,3110,573522418,2022-10-31
c75fa6d5583d7543,t-mobile,480776120,24409283,1295708,58359,506539470,2022-10-31
2ccb86c5e0b324f4,verizon ,538811395,68213653,904629,114055,608043732,2022-10-31
8d8eb818190ceef5,t-mobile,832356965,66888916,38797,12891,899297569,2022-10-31
b66d8d1d5c7526c0,t-mobile,3577908846,92376891,839848,118051,3671243636,2022-10-31
763e3a15f2ad4ef7,at&t,384700688,47611599,2140504,427957,434880748,2022-10-31
2865db9d1d285814,verizon ,728232655,68954322,416,170,797187563,2022-10-31
8998ef7e6bd58dd2,,28515,7520,0,0,36035,2022-10-31
8cf46118f726e062,,272069197,4749342,0,0,276818539,2022-10-31
43423fc78078db82,,415857079,34159466,0,0,450016545,2022-10-31
ab606b4ef978d849,metro by t-mobile,1245972287,29237709,6935,2068,1275218999,2022-10-31
0a34ada5cd18bc19,mint,505959166,55306860,997043,142344,562405413,2022-10-31
ab4e653f76babccf,t-mobile,869363061,37664568,167408,41115,907236152,2022-10-31
cd68f3634ae01431,at&t,1398825225,107921769,33669,9094,1506789757,2022-10-31
c0ccd93d4a1ac7aa,verizon ,475080783,58240251,2363160,405143,536089337,2022-10-31
c74aa15e58949d88,verizon ,401511448,47439516,84,84,448951132,2022-10-31
080f715577007c70,mint,1149719799,35349958,622228,17296,1185709281,2022-10-31
b69c04a02fa592b5,mint,922300500,54537319,672276,39841,977549936,2022-10-31
533dc2d6455f96b7,verizon ,593880329,68890502,119706,49979,662940516,2022-10-31
2072faa93555bf08,google fi,1539893581,85585334,2022782,300522,1627802219,2022-10-31
d70b7e7948d12e90,at&t,925162856,38264708,84,84,963427732,2022-10-31
d9cd2b3d58065f00,at&t,765315361,72208203,28537,6637,837558738,2022-10-31
faff69141ed7933e,metro by t-mobile,674742219,47167388,625371,59339,722594317,2022-10-31
a34eb06fda0ac501,,1083323433,66503804,277260,100662,1150205159,2022-10-31
7e647f9b32028488,verizon ,627232747,52664567,1465327,348820,681711461,2022-10-31
34e2b03270959e83,mint,967169508,65310753,1698961,592331,1034771553,2022-10-31
40076a30c97b839e,verizon ,774500837,64197968,898913,116264,839713982,2022-10-31
44d678fd3c0653bd,at&t,1305932187,77987869,6465,1649,1383928170,2022-10-31
02cf3ca66268faa3,verizon ,1657140696,84602626,960813,131796,1742835931,2022-10-31
8664d874afe0f46a,t-mobile,851677459,28841773,0,0,880519232,2022-10-31
9aa10b8b240f771e,t-mobile,3361792787,114803584,4571,10099,3476611041,2022-10-31
bcb2293586911d5f,mint,3695182304,79511557,768129,73998,3775535988,2022-10-31
88ceb21f0fb203a2,mint,574136839,47786252,17,252,621923360,2022-10-31
b2e4fd9825bb5a55,mint,371263328,32824390,1105199,188127,405381044,2022-10-31
02c558ca13bb9644,mint,447223969,28176303,107074,36999,475544345,2022-10-31
549eece57ea2674a,t-mobile,1133551320,54135171,101301,39189,1187826981,2022-10-31
bd028518530be054,at&t,444020545,25408541,953970,137982,470521038,2022-10-31
ec327b63fed5fa34,at&t,954505071,54029962,243688,55551,1008834272,2022-10-31
12a3c82c38801c95,t-mobile,639478956,35905967,887527,123886,676396336,2022-10-31
4e170a417412650b,mint,319747353,38204598,6744,2055,357960750,2022-10-31
d6c5f05ec3f00001,mint,2121238248,67271026,1321719,256844,2190087837,2022-10-31
2069c82de173cf6b,t-mobile,458081997,39923533,368633,36147,498410310,2022-10-31
bf02d76f9d4c8d68,at&t,0,0,51059,183469,234528,2022-10-31
7b24aa28e56795b4,t-mobile,535044062,4977476,714062,82047,540817647,2022-10-31
ef58a3e25c83bd3c,at&t,2225269711,50555301,171,130,2275825313,2022-10-31
231b35f729511a57,at&t,1041740497,44225533,1399532,232063,1087597625,2022-10-31
0416542456bb986c,mint,542803117,44027601,14098,3944,586848760,2022-10-31
ec22684d02b3abc9,,149222077,3576581,0,0,152798658,2022-10-31
286b539223b93de3,,150025140,2755435,0,0,152780575,2022-10-31
ae83da956bd049ed,t-mobile,371122624,17797324,6935,2068,388928951,2022-10-31
909bb4b71a423514,,149430398,3235827,0,0,152666225,2022-10-31
52a0338c2c43a0c6,mint,1420603868,42903092,66326,29513,1463602799,2022-10-31
60e42f3ec4a7ef77,,149441941,2806867,0,0,152248808,2022-10-31
52df9afa3e4b4f97,t-mobile,2381258075,61548047,630608,35841,2443472571,2022-10-31
8bfbf5676fec8d9a,at&t,796802429,73084797,140285,366605,870394116,2022-10-31
93039951dc541264,mint,0,65,1317542,247264,1564871,2022-10-31
2de284085ed9ddf2,verizon ,1077104397,69048815,6661,1741,1146161614,2022-10-31
0a2b7980214cd6f9,t-mobile,326816116,39447098,1205424,226943,367695581,2022-10-31
bffe4d7139973d47,verizon ,617435285,67919903,20492,6180,685381860,2022-10-31
99b711af1961caaf,at&t,1051699360,95214577,682889,39312,1147636138,2022-10-31
563c0880af8fc454,t-mobile,661304994,93791381,11809,1944,755110128,2022-10-31
6a553c96bbac1494,mint,245975160,4858628,1116332,91518,252041638,2022-10-31
11355e84b69e3f35,,104612007,3889775,0,0,108501782,2022-10-31
28d1708976fcc040,t-mobile,511660424,67899850,104,104,579560482,2022-10-31
84e0bc2840998846,verizon ,0,0,2051342,300913,2352255,2022-10-31
6c8ed7111901396b,verizon ,954999532,75174610,396297,123701,1030694140,2022-10-31
6d6a3630fd047ffd,at&t,978494177,78889644,682481,55361,1058121663,2022-10-31
c0f955b06107c6d2,verizon ,1311581377,87370649,821512,101078,1399874616,2022-10-31
5bfbc9740fc2ec3c,mint,3501276150,77360318,1330504,90622,3580057594,2022-10-31
44a872f2861167c0,,68814919,1857777,0,0,70672696,2022-10-31
d94d988b39dea9af,mint,1315937312,11436383,1833440,244347,1329451482,2022-10-31
c69529487f4ad7f0,,1360950392,104572297,307,3771,1465526767,2022-10-31
033b181795b892a3,,162383059,2845528,0,0,165228587,2022-10-31
5830f994ce79987f,,109776282,2268956,0,0,112045238,2022-10-31
d49c8fb8a401b18c,,162309080,2268242,0,0,164577322,2022-10-31
6e2d038e1d8856d0,mint,569214330,44967261,7044,2212,614190847,2022-10-31
3aba0ab17c7a658a,mint,284191305,19725570,1800879,247887,305965641,2022-10-31
b35615d57faf7a35,at&t,1034780903,71993952,20787,6200,1106801842,2022-10-31
a602a7af6cdc3a5f,verizon ,776751250,41008077,1626519,362825,819748671,2022-10-31
bbf99dad7f63c11f,at&t,7431594606,91745444,8199,2508,7523350757,2022-10-31
37b80556df3e33c1,verizon ,393306177,38405447,1100602,186428,432998654,2022-10-31
0d0df8923317bb12,at&t,1191424962,55624135,324442,12320,1247385859,2022-10-31
f69a70375532d8fd,mint,502202651,41853629,1350357,109611,545516248,2022-10-31
9cbadf3209ecab06,mint,1506561794,42043196,88027,53551,1548746568,2022-10-31
25666cf1e74e3608,mint,744128933,47932521,7044,2284,792070782,2022-10-31
d46cb1965a86af03,tello,8474152630,114333906,28056,9086,8588523678,2022-10-31
587d4a7455770482,t-mobile,301005550,11376150,6935,2068,312390703,2022-10-31
ec10f20acee74047,t-mobile,883430785,48373437,0,46,931804268,2022-10-31
e189afc03d327cd1,mint,852288084,63070953,1181792,121911,916662740,2022-10-31
081a874ec4ad7863,mint,2657720725,38279969,1351869,89510,2697442073,2022-10-31
a0b90aa6a69532d2,mint,1129624098,76596401,7719,2058,1206230276,2022-10-31
f84dc0725c95ea17,t-mobile,523563607,49010318,0,2,572573927,2022-10-31
1d5448272e753395,mint,886836321,69378219,432508,84491,956731539,2022-10-31
611fe71988af1deb,mint,851627702,64672711,72842,27883,916401138,2022-10-31
3ecbe9e005f36501,cc network,657510611,61280719,374171,159901,719325402,2022-10-31
84f37284e19a1232,mint,2367532802,84707244,26,47,2452240119,2022-10-31
9210c7657b60aaf4,t-mobile,413204146,33687580,1024239,160382,448076347,2022-10-31
2c84208211dfcd41,verizon ,712187768,64660401,13195,5971,776867335,2022-10-31
4cc77d190a9d07c3,t-mobile,880251479,61062576,1901587,298827,943514469,2022-10-31
696d972663859117,verizon ,313354209,31372570,282731,30210,345039720,2022-10-31
718eb059802c745d,verizon ,779332052,28845672,1338537,84885,809601146,2022-10-31
1b7ffecd57a8495a,at&t,570761027,67127834,1018932,176057,639083850,2022-10-31
327eddf9cef1a248,verizon ,771269534,34968081,1010128,139574,807387317,2022-10-31
1893007eef54b5a6,verizon ,802363595,46960233,655836,36349,850016013,2022-10-31
3374668986615a85,t-mobile,305837426,11184529,2013021,307532,319342508,2022-10-31
f7517de4f23dfe79,verizon ,0,0,36098371,1372801,37471172,2022-10-31
c3383d9028154119,mint,1132925954,91380992,68127,29113,1224404186,2022-10-31
b5d035bf70c6f693,mint,876120005,84451045,1143964,206191,961921205,2022-10-31
dc63edeede21348c,mint,407463852,54787212,9,156,462251229,2022-10-31
d2d0afea9d42f633,verizon ,315832946,45811486,714382,49753,362408567,2022-10-31
d44e9481100cb9a7,verizon ,1171704576,28145845,1351894,121762,1201324077,2022-10-31
748d2394de371151,,712431491,72544550,0,0,784976041,2022-10-31
40a6958fec5ecc27,tello,3283,3855,1637965,292010,1937113,2022-10-31
1cf3135b7d63a26c,patriot,871015374,75066502,1097387,199497,947378760,2022-10-31
079e32b4f2942991,mint,513637842,35030289,1166940,208907,550043978,2022-10-31
baceb736a2da7130,mint,1714285930,40163946,665338,67048,1755182262,2022-10-31
e3c0f03dcf0e4b91,at&t,451739513,28560851,2050471,344712,482695547,2022-10-31
9d208aa279d0fa76,verizon ,667397125,74989012,1897272,262691,744546100,2022-10-31
4a0c13e3c8aafc8e,,277827918,20765519,0,0,298593437,2022-10-31
0c2f9bcbe1ecb504,verizon ,2248803196,81172983,1428599,286819,2331691597,2022-10-31
d8c4b695b3fce012,verizon ,319412005,33092746,1149481,224591,353878823,2022-10-31
df143b3b273b3a34,verizon ,14283789285,204699553,2048704,279265,14490816807,2022-10-31
ac4d41fee113bb9c,t-mobile,523555740,49529242,74715,23751,573183448,2022-10-31
52c41d93e28d4a60,verizon ,1175777686,57653094,2544,961,1233434285,2022-10-31
14e369debf26ce06,at&t,518216244,44669965,14170,4588,562904967,2022-10-31
b2018bc8a5289e21,verizon ,624744458,64716267,639662,21268,690121655,2022-10-31
25b5ab22fec9b1df,verizon ,325925235,49187496,13595,4382,375130708,2022-10-31
19b3a6311bdcb1e9,mint,0,0,622408,31609,654017,2022-10-31
6fd7a364392ad0ec,cricket,621675487,55688875,2132402,624559,680121323,2022-10-31
c46cf60b343351ec,at&t,720707332,88868848,40382,11341,809627903,2022-10-31
aecb5fbef1f78df6,verizon ,579387223,67310538,1886933,253897,648838591,2022-10-31
cff2181ed7e2e67d,,157831860,3077170,0,0,160909030,2022-10-31
27ba1c531e6741c3,verizon ,677089840,47577326,13807,4173,724685146,2022-10-31
6bb66c1b8bdbf172,verizon ,956576252,63729470,637177,44093,1020986992,2022-10-31
82d56cadeea7bc58,at&t,4437724645,72481050,873713,57516,4511136924,2022-10-31
77946b68cb02ee75,mint,122634993,10480703,498,3339,133119533,2022-10-31
8495c0da028dba83,mint,250635589,16347712,308278,229402,267520981,2022-10-31
2988de48dc9e1b9d,at&t,261682292,4739943,2297033,483429,269202697,2022-10-31
26bc773d8068e409,metro by t-mobile,15435066365,220777087,41,21,15655843514,2022-10-31
48623add5f0b94a5,mint,725002103,66798571,846090,113854,792760618,2022-10-31
8c5ba2ef21de2c35,mint,254847560,14092860,654019,186782,269781221,2022-10-31
751793cd499aaa36,at&t,1056281295,56578265,6,15,1112859581,2022-10-31
0b3d86198fab0483,t-mobile,859629744,56685517,655847,25744,916996852,2022-10-31
ebe3e2447e054ad0,us mobile,1719902305,65474293,1744091,376525,1787497214,2022-10-31
2ea8cfb19eaec106,mint,1952495538,45467404,112305,30238,1998105485,2022-10-31
1e34b4cca33f7c97,mint,695455089,57272874,815673,77937,753621573,2022-10-31
5c9c07d1af0d988f,t-mobile,2750189913,154048227,29594,9248,2904276982,2022-10-31
9e0d92d642a373c5,bell,2233637502,83452725,291,10014,2317100532,2022-10-31
5ea2242a762881c0,t-mobile,1033823298,18746417,41214,10546,1052621475,2022-10-31
b4cdc3a2e6a70c13,at&t,971867606,21290576,961834,148432,994268448,2022-10-31
3ef1295299f9b5ed,,146079272,3021383,0,0,149100655,2022-10-31
03dc6396f83c47e4,mint,579902543,46666701,2067233,348673,628985150,2022-10-31
bb324d84feaa1374,mint,5730814810,36122130,1193965,267883,5768398788,2022-10-31
ef0833875d5a07cc,mint,2088418150,74602555,21158,13973,2163055836,2022-10-31
ae51c0c1fb743530,,89899074,2031835,0,0,91930909,2022-10-31
d62919fb330caa7d,at&t,1216344483,70776865,661244,41433,1287824025,2022-10-31
6278358da9707dae,mint,3210893226,71040676,302935,113838,3282350675,2022-10-31
6a439eb86336a4dc,verizon ,550597253,54396169,1977471,267719,607238612,2022-10-31
de7d5efca48f7f83,verizon ,32134969,4697093,617707,28712,37478481,2022-10-31
fd574d2fda643385,at&t,854121669,48532643,546,505,902655363,2022-10-31
635c3eff0d7423c8,verizon ,1589673575,78807275,1466517,322643,1670270010,2022-10-31
9a5df3895ae7aa6a,verizon wireless,833026584,67402373,6661,1637,900437255,2022-10-31
092c27ef2feb5096,at&t,1189831024,47663325,20683,19305,1237534337,2022-10-31
331a7921b853bac0,at&t,724542121,73329205,340067,135113,798346506,2022-10-31
766a96885d4ba087,mint,792931695,77166171,1941498,1015572,873054936,2022-10-31
98fc13056654f163,verizon ,283287,93960,1986614,282876,2646737,2022-10-31
98d8ebd433bdf3c3,verizon ,942066029,18032148,979439,48448,961126064,2022-10-31
e229477732b37a47,at&t,449633987,37666335,148,1686,487302156,2022-10-31
1f2ee27e8a8fa50b,t-mobile,588641399,59631123,21785,6978,648301285,2022-10-31
b5b76fb9af4ade0f,at&t,733095187,51808260,22789,8101,784934337,2022-10-31
7e5cd4dab9fec3c4,mint,0,0,939863,160982,1100845,2022-10-31
657cae7e1792d148,,175523125,3140964,0,0,178664089,2022-10-31
4f5009cc0669f1bf,,66863604,1602169,0,0,68465773,2022-10-31
533927184b0a889d,t-mobile,1471457134,36213120,83,64,1507670401,2022-10-31
fe75fa2dc3a37f4f,mint,691574486,24579107,658086,49268,716860947,2022-10-31
e6bfc9c053b30d53,,155910172,2836133,0,0,158746305,2022-10-31
97384bfa7b7c3bf3,verizon ,2116103943,87614415,1368291,52125,2205138774,2022-11-30
49e64d5ae546f548,,78254200,3172922,0,0,81427122,2022-11-30
dd6d7086347cb2ab,,138233397,4049881,0,0,142283278,2022-11-30
1a4e9e05af6b6ad1,,65229977,2259364,0,0,67489341,2022-11-30
0bcef02d04537318,verizon ,5766513823,119270678,773370,170353,5886728224,2022-11-30
0650672a456e5030,t-mobile,1280165080,86683578,1018035,158794,1368025487,2022-11-30
23d3dd7b1a9c9c5d,t-mobile,1630598479,75402574,55637,18525,1706075215,2022-11-30
888a652f5dc44cf0,,189041092,2598370,0,0,191639462,2022-11-30
e5ab3cb506418067,,66642345,2661087,0,0,69303432,2022-11-30
6f051c169fc83aa2,,119601144,3954054,0,0,123555198,2022-11-30
da527d1573e6ae01,t-mobile,1287853909,26436064,1192124,209623,1315691720,2022-11-30
977f6a1931caf8fc,at&t,1850495189,50178244,0,130,1900673563,2022-11-30
e45a26a3656354d7,,169731160,2088990,0,0,171820150,2022-11-30
131d5e82ae219336,,54259182,2491334,0,0,56750516,2022-11-30
e96bdfc9a4a4973f,verizon ,815851379,66448248,6658,2165,882308450,2022-11-30
e9ae727338af6e0f,,157209300,1909394,0,0,159118694,2022-11-30
0a1780f83bbf63db,,157806814,1907822,0,0,159714636,2022-11-30
d2be5a4eece52e81,,157200983,1715709,0,0,158916692,2022-11-30
dca98b7a6851f31c,,157452915,1673165,0,0,159126080,2022-11-30
312d87e95cc3319d,,157249688,2225733,0,0,159475421,2022-11-30
cc1ab33385f13ac0,,157858214,1953277,0,0,159811491,2022-11-30
6bf1af0e6e3f2f59,,157409183,1743143,0,0,159152326,2022-11-30
25e0cb2bf89f41e2,,157805095,2258536,0,0,160063631,2022-11-30
15b770c9702a42bd,,157837535,2094100,0,0,159931635,2022-11-30
08d169b5ba2fb29c,,157880978,1722553,0,0,159603531,2022-11-30
dbe2585e98fc7064,,157267614,2133568,0,0,159401182,2022-11-30
6589ee7e6e1abf90,,157175247,2016907,0,0,159192154,2022-11-30
2101bef49fe8d127,,157171426,1692570,0,0,158863996,2022-11-30
4d6350a301eb1b56,,157260794,2063209,0,0,159324003,2022-11-30
026ffd0dbe42feac,,157800608,1073547,0,0,158874155,2022-11-30
df7d31c3a9455b79,,157175465,2283976,0,0,159459441,2022-11-30
e3484a37b57bc99c,at&t,185695498,4890979,770735,157008,191514220,2022-11-30
a3d0c24fbfd4974b,,2824895901,25761941,0,0,2850657842,2022-11-30
475830c51b5e6e60,,74403866,2646127,0,0,77049993,2022-11-30
e660f2cd81d15b8c,,81803902,2831466,0,0,84635368,2022-11-30
594845df23ba3e3f,,184883108,5035339,0,0,189918447,2022-11-30
f4a03257da7a33a3,,167405390,4097828,0,0,171503218,2022-11-30
52cb8e8692ba5363,,167808366,4850425,0,0,172658791,2022-11-30
6d16525c4326a6fd,,84699977,3449237,0,0,88149214,2022-11-30
cb692353130a639b,at&t,311435907,14951358,2088012,319501,328794778,2022-11-30
5d92b6c36ee9caf5,t-mobile,233999220,6022195,0,0,240021415,2022-11-30
86777ebbaf64f951,,169144905,4315097,0,0,173460002,2022-11-30
9008c0c26b2bbb83,,186384108,4871656,0,0,191255764,2022-11-30
507751451d464eca,,171659886,4832008,0,0,176491894,2022-11-30
ae593e9f176c45ca,,235796713,4716865,0,0,240513578,2022-12-31
79169658f899d821,t-mobile,0,0,0,0,0,2022-12-31
34e5ecaf77d3da4c,t-mobile,0,0,0,0,0,2022-12-31
7d9325b48971f8c5,,515583,133592,934637,300916,1884728,2022-12-31
7383b97d029ecba3,Verizon Wireless,0,0,0,0,0,2022-12-31
8ccdb40354711f80,t-mobile,0,0,0,0,0,2022-12-31
699691e9446834fc,Verizon ,14711632149,347949121,219574,81718,15059882562,2022-12-31
193d8e2fd2bc7c1d,verizon ,63472,20791,1009617,399848,1493728,2022-12-31
b365c91680c07736,verizon ,816189926,43030780,20817,6332,859247855,2022-12-31
98c3a9d74d623e0e,verizon ,12354564828,208038133,2155677,301681,12565060319,2022-12-31
f788640b075aa01f,t-mobile,0,0,0,0,0,2022-12-31
fffd37727f5d211e,t-mobile,270471,71409,424484,130113,896477,2022-12-31
df7eaec7c96bdb76,,414441360,7656618,0,0,422097978,2022-12-31
a783e564a94635e6,t-mobile,0,0,0,0,0,2022-12-31
c391bd2c3e58917a,t-mobile,0,0,266499299,7059324,273558623,2022-12-31
5a4e723bb3623958,,745900,209525,0,0,955425,2022-12-31
a40221fc87e2bf58,,25330020,729846,298,8786,26068950,2022-12-31
70e822b93fb9297b,,119143875,18187887,0,0,137331762,2022-12-31
8388ec0e8f27d672,,330525978,5588819,0,0,336114797,2022-12-31
6a7935a6ed4c2a06,t-mobile,0,0,0,0,0,2022-12-31
afe58ded26003070,t-mobile,556256424,35683010,0,10139,591949573,2022-12-31
b7719cfdabac5bf9,t-mobile,0,0,0,0,0,2022-12-31
e6372ee8a7c36bd2,,554446,197021,0,0,751467,2022-12-31
8c30d62918173b27,,823239,277102,424253,159907,1684501,2022-12-31
ebaad27218c9a1dc,t-mobile,0,0,0,0,0,2022-12-31
90aaeaa9ad1a2721,t-mobile,0,0,0,0,0,2022-12-31
832b0926417dee0b,t-mobile,0,0,0,0,0,2022-12-31
9d57214cf3aab81f,,809109501,15016845,0,0,824126346,2022-12-31
2a0d09e691214168,,632713558,10073792,0,0,642787350,2022-12-31
beae07f986f6cdf1,t-mobile,432284534,6676455,23722,7500,438992211,2022-12-31
1cbf17ee9bf613ff,t-mobile,0,0,0,0,0,2022-12-31
80630c1258eb8f01,,8226,1970,20982,8133,39311,2022-12-31
b7b7f9eb832d11c1,verizon ,992555297,96012849,1447004,58061,1090073211,2022-12-31
9434241933bc8b48,,1153241125,71450813,1241038,838860,1226771836,2022-12-31
d7dd3c41097e4af8,,1334770111,62230414,710429,20325,1397731279,2022-12-31
81879b24e66f9ed2,home,36143,10859,0,0,47002,2022-12-31
b62294c10dfc9306,t-mobile,29759,9298,0,0,39057,2022-12-31
5b8e7e1cc93e9606,t-mobile,299696293,5971666,0,104,305668063,2022-12-31
62fb3608dc5a0ed7,t-mobile,245120292,20370403,14657,5629,265510981,2022-12-31
fcad44b3f812ee6e,,538741,180726,0,0,719467,2022-12-31
37d11e56bc15f52f,,672857642,10450869,0,0,683308511,2022-12-31
4bba535a6036b68e,,2353562965,76642406,13376,3849,2430222596,2022-12-31
fc03cdccd0bd62e2,t-mobile,593405,183717,614080,244962,1636164,2022-12-31
ab89d57ad358a2d4,t-mobile,705710572,64856058,743702,49208,771359540,2022-12-31
ac836caf6c0780fd,t-mobile,39700395701,667820519,31427,17989,40368265636,2022-12-31
b92ec139d9a5117a,verizon ,617624035,8788814,39182796,1904508,667500153,2022-12-31
8829feec0786962b,mint,0,0,0,0,0,2022-12-31
62e4455b1cfe5584,,2532620069,45959238,0,0,2578579307,2022-12-31
12d97a7f7d431f36,verizon ,51681966,2942971,26762,9550,54661249,2022-12-31
d56c16e8b3aa7b9b,,12586,2190,893696,758382,1666854,2022-12-31
cd64163aaaa8d628,t-mobile,717407113,68872900,1583280,283496,788146789,2022-12-31
d586c90d03154b55,t-mobile,886365926,68151873,20807,7611,954546217,2022-12-31
83a27b187870e8be,,865604,275684,0,0,1141288,2022-12-31
bd7d522e563e241f,,19967602,1158439,0,0,21126041,2022-12-31
0f1fe1424d8489be,t-mobile,0,0,0,0,0,2022-12-31
8c7cee0375bdb5ff,t-mobile,121050391,2825166,0,0,123875557,2022-12-31
cea5ee2a1b3fa326,t-mobile,520878,189711,0,0,710589,2022-12-31
8f94345977625976,verizon ,2625499652,52085871,0,0,2677585523,2022-12-31
46055cc5fec8d459,t-mobile,0,0,0,0,0,2022-12-31
8bdae4e0d0ab007a,,1243099334,37454239,0,0,1280553573,2022-12-31
fb318218844cb0ea,t-mobile,5173653904,152290839,1125,6737,5325952605,2022-12-31
1adb1ad3baffc6e1,t-mobile,119107321,2084299,451273,161057,121803950,2022-12-31
c3b691cfe69898f6,ting,0,0,0,0,0,2022-12-31
4d37ed5f869d8d11,,712734299,11248916,0,0,723983215,2022-12-31
9be31c98ff1592c8,,619203037,9781380,0,0,628984417,2022-12-31
5ac58e822e1d5baa,t-mobile,0,0,0,0,0,2022-12-31
813b5d1603077604,,792578,256977,525686,161115,1736356,2022-12-31
e0bc5d016169ec30,,124649245,1031244,0,0,125680489,2022-12-31
026a02d4b0761cd5,,869830,277651,441481,127537,1716499,2022-12-31
63fe60b3e8dbd429,t-mobile,879299,337465,102944,40014,1359722,2022-12-31
803575794325f6eb,verizon ,0,0,0,0,0,2022-12-31
20a5483e75dd09c8,mint,574184089,40241120,2865469,598576,617889254,2022-12-31
27bb9ea34f7dd580,t-mobile,1215703162,17503601,31300,12418,1233250481,2022-12-31
1faaddcf7c8f7c5b,,39435231,4767088,0,0,44202319,2022-12-31
e8582351bee35988,ting,1077638522,78537236,6621,1753,1156184132,2022-12-31
3bed6e41e0a31552,t-mobile,180041,349452,0,0,529493,2022-12-31
199b431537dc1ce5,verizon ,22246296325,400948773,1349984,92858,22648687940,2022-12-31
482b9c8e531e162f,verizon ,2868617939,114715182,13322,3745,2983350188,2022-12-31
cea64583f2dc0c42,,847033259,25837464,0,0,872870723,2022-12-31
e927bb3eeb020791,,801884,363776,144280,62257,1372197,2022-12-31
1dd835e16286c791,gsma,137173930,1531542,393766,94778,139194016,2022-12-31
6dbae2a50d251195,,8677885192,136877205,0,0,8814762397,2022-12-31
82295f6650408c24,t-mobile,1059882237,40037380,112794,134979,1100167390,2022-12-31
6e390ce9f9fe529d,t-mobile,790461,223545,467591,160409,1642006,2022-12-31
9936214cda14bf62,roam,1270398887,17458384,0,0,1287857271,2022-12-31
3152f981be666108,t-mobile,815826,245082,263500,106520,1430928,2022-12-31
8a7786a57c81af1f,t-mobile,38074,13942,95594,59082,206692,2022-12-31
1e0ba350fbec1a6f,at&t,1297886,338210,84,84,1636264,2022-12-31
dd53692d02df18e3,,105995917,2062511,0,0,108058428,2022-12-31
4542fe4065388cf7,verizon ,8685665730,217884172,912889,113903,8904576694,2022-12-31
a7334b9ffd25b047,verizon ,20969,10001,0,0,30970,2022-12-31
9ecf809d545220e3,,60860,201993,75204,29935,367992,2022-12-31
72a07344ecdaa692,t-mobile,43676035,1247409,263611,178600,45365655,2022-12-31
2c554c7d22c0ecf4,,8670,6024,53411991,2103482,55530167,2022-12-31
0429b4f51108ac56,verizon ,396998173,6027245,20568554,579334,424173306,2022-12-31
d8ef3308711664a5,verizon ,0,0,811290,298182,1109472,2022-12-31
5332decb1c966fec,mint,610769476,32221329,47121,378366,643416292,2022-12-31
6a36c5d2a9b6cf4a,mint,100316,40713,251003,222513,614545,2022-12-31
1a08227b689cfbf8,verizon ,9806713336,173318784,1132,11808,9980045060,2022-12-31
532f986ec6d99510,,701671,245832,321852,109038,1378393,2022-12-31
65057c0d48f7fb26,t-mobile,544766229,40187081,908117,174202,586035629,2022-12-31
ac1648eaee61e03b,,347294516,7125270,0,0,354419786,2022-12-31
623c54d8333596a1,,84,84,189388,48209,237765,2022-12-31
39baf7f157991f0b,mint,347894629,4469727,16409,8888,352389653,2022-12-31
67c32789b2b5258a,,824353380,34194154,0,0,858547534,2022-12-31
6df52e648a731032,t-mobile,437382854,6117231,0,0,443500085,2022-12-31
0249ba6639509a05,mint,13364863874,216920145,0,0,13581784019,2022-12-31
1644e990458a58c3,mint,0,0,1723242,231477,1954719,2022-12-31
fd6c7a1e11ddeb62,verizon ,805387,220553,286703,103597,1416240,2022-12-31
801c6459921418c8,,590995158,25358341,0,0,616353499,2022-12-31
a642e18a6746b57f,,767559,273268,228861,76397,1346085,2022-12-31
2dc9a79813fc35a1,at&t,225235,172963,16366563,400692,17165453,2022-12-31
d71ead6203fcd17c,,1398814728,19743843,0,0,1418558571,2022-12-31
48f22c6088a13c03,verizon ,742554218,67193188,6661,2315,809756382,2022-12-31
fa04fb1e20c750f7,,69924173,1026376,333014,108601,71392164,2022-12-31
cf63d30cbefda27f,mint,225524584,20100496,36815,15802,245677697,2022-12-31
93331186a80dbac4,,317984,502664,173939,274321,1268908,2022-12-31
732df7049e90729a,t-mobile,1037582,317797,74588,24255,1454222,2022-12-31
42b5ce7b1049554b,verizon ,64007972,11552162,1167730,150462,76878326,2022-12-31
2d2375fbe7437cdd,t-mobile,246344725,2459135,7077,2117,248813054,2022-12-31
bb5035ce6e437875,verizon ,326946810,32265382,749578,64256,360026026,2022-12-31
d3d9b1a56f8c8fe6,verizon ,0,0,2124516,288730,2413246,2022-12-31
564e04e31a4b3f38,red pocket,43752363,743417,0,0,44495780,2022-12-31
72f7e0ce3f158ddc,,768741,230970,227239,82137,1309087,2022-12-31
65a35c9976159b14,,629718,183291,84,84,813177,2022-12-31
3e5ad467bb0dc1f3,,57189607,11826819,6719,2033,69025178,2022-12-31
b66ba6908952698d,mint,709336,204819,108576,55631,1078362,2022-12-31
5d7a640a11e62ccc,mint,785620,278732,20235,7024,1091611,2022-12-31
3fd7a82e7a936df5,mint,788475200,30907076,2074086,399951,821856313,2022-12-31
cd39d1f653e9af96,t-mobile,727,12316,29848,19319,62210,2022-12-31
ef3e4924d5485c25,home,113886,42654,873224,363288,1393052,2022-12-31
9c35abcccb7bb9f9,mint,47408,127709,10321,3002,188440,2022-12-31
3b70f4b13aa007ed,home,94062604,2006175,754000,233736,97056515,2022-12-31
e894c104b48a6551,mint,991221207,24044034,146223,61207,1015472671,2022-12-31
dd53feca36cb754e,mint,704101736,12249490,0,0,716351226,2022-12-31
2ad48a03f0033638,t-mobile,545109,163564,0,0,708673,2022-12-31
46f89486f529bf39,mint,169339,163951,120644,45893,499827,2022-12-31
7cedcd3f2f6b02a9,,3157493,85754,0,0,3243247,2022-12-31
48ed7a83bd91fbe7,,1166474117,57982017,7242,2510,1224465886,2022-12-31
32aed34dd63eecd2,mint,574579,341629,277840,138710,1332758,2022-12-31
81e00e1ce7189ac1,mint,83480908,1136276,9537,2723,84629444,2022-12-31
ccd4b4906c2661ef,t-mobile,392928,121748,411668,119630,1045974,2022-12-31
122cc3881d17a094,mint,352531,103087,240237,73204,769059,2022-12-31
97d0d3735aa27340,verizon ,409905465,9335400,1565171,227534,421033570,2022-12-31
82a1bcd29803d63d,verizon ,27029593103,509808709,1449361,224673,27541075846,2022-12-31
8d62cd9d6bf30413,verizon,340039000,11801439,0,0,351840439,2022-12-31
d6e923cf18a68ff3,,948533,285821,902091,314825,2451270,2022-12-31
9b76c0a541eca965,mint,766594,276902,248893,99304,1391693,2022-12-31
fdd2672fd3649916,t-mobile,0,0,859815,247474,1107289,2022-12-31
930cd72e67f3564a,home,434788108,39146489,1500416,91248,475526261,2022-12-31
e5bfbe540f6880a6,verizon ,2588069081,68871053,1511341,95622,2658547097,2022-12-31
e4ee4399d59ed787,mint,136327402,4684018,39879957,828261,181719638,2022-12-31
60306194de153f4a,mint,11515096,441243,857253,449596,13263188,2022-12-31
072ebe97927e9c18,mint,696546,210593,0,0,907139,2022-12-31
c77adbeabc7cb42d,,20993497,377504,0,0,21371001,2022-12-31
c99ecc8c09952678,,2154301779,31217779,0,0,2185519558,2022-10-31
cb48ea8a1bce25cb,,293791498,16981439,0,0,310772937,2022-10-31
2b8e16f2e83ff904,at&t,947210276,53300117,155623,19488,1000685504,2022-10-31
f256a0e02c8b464e,,240586767,3540858,0,0,244127625,2022-10-31
f3b166562548c2ce,truconnect,12106050990,245989495,61566,21903,12352123954,2022-10-31
0128b67fde55501e,xfinity mobile,3308932795,56702160,27158,8169,3365670282,2022-10-31
b138215797c500d8,at&t,1066533609,72511092,1926536,341242,1141312479,2022-10-31
9e49fcb44ceb7ddc,verizon ,41209553,1768420,2041941,334411,45354325,2022-10-31
a98ecfed194af6b1,t-mobile,6115630652,137172333,656909,42006,6253501900,2022-10-31
0c3495c74d57b7b3,verizon ,1104527739,47629207,0,12310,1152169256,2022-10-31
dfc0e5a8acc04f0a,t-mobile,1303883499,70179177,115964,46609,1374225249,2022-10-31
a88ccaa2b8b2efc5,globe,410847626,8357900,0,0,419205526,2022-10-31
9cf69bfb1c53de86,,155214309,2166262,0,0,157380571,2022-10-31
a5dbd89c0a60ceda,,154665733,1816891,0,0,156482624,2022-10-31
9daacc582c4f150e,,154353425,2289173,0,0,156642598,2022-10-31
343a566b1e735888,,154642986,1730626,0,0,156373612,2022-10-31
b5fc1c4d03a3cf43,,154447635,1994917,0,0,156442552,2022-10-31
47b0060e90c83708,,154597805,2291375,0,0,156889180,2022-10-31
d9939f03a38bfd8f,,154299609,1910664,0,0,156210273,2022-10-31
ae09f06ca4ed0250,,155160575,2721029,0,0,157881604,2022-10-31
dbaf7a481962fd41,,163994678,2060645,0,0,166055323,2022-10-31
9ed3b9eacb4d6165,verizon ,703288493,21031807,1228179,208495,725756974,2022-10-31
b93d1b941af991e0,,163675384,4527622,0,0,168203006,2022-10-31
9dd0eeb578e620c6,at&t,2708473254,31543506,35106,17563,2740069429,2022-10-31
ed5f28b70f26dcfe,t-mobile,2649092893,40532274,886454,52926,2690564547,2022-10-31
ac8cd0ce9916528a,at&t,865149370,17436921,1370054,313981,884270326,2022-10-31
c2b443b98a984d10,mint,1008060028,38093678,0,1652,1046155358,2022-10-31
ea8b3680efdfda2e,t-mobile,163053222,13851025,103940,41120,177049307,2022-10-31
568154bf9d2760b2,,461469361,13176638,8220,3933,474658152,2022-10-31
6e2c763eb0352f8e,,100769506,3083617,0,0,103853123,2022-10-31
9cb641b844758417,,328687903,3664207,0,0,332352110,2022-10-31
343082ffd3a21fd3,,123893175,2453552,0,0,126346727,2022-10-31
c7c377261a466ab3,,84689991,2053952,0,0,86743943,2022-10-31
4224a9b396da0981,,389554278,4190541,0,0,393744819,2022-10-31
3864993a3add8eca,at&t,1044328245,20932328,1319273,140958,1066720804,2022-10-31
8ecef0bd55ed8248,,74315346,2866773,0,0,77182119,2022-10-31
6ddf846743f38f1b,,80697666,2865240,0,0,83562906,2022-10-31
89eb850fcd97eb21,,65697348,2694872,0,0,68392220,2022-10-31
e33d40b5fa80b83b,,99042938,1834161,0,0,100877099,2022-10-31
195910a0b9617854,,162728016,1428519,0,0,164156535,2022-10-31
6a87ce453f132e0e,,56843421,1907475,0,0,58750896,2022-10-31
04a5bd623950df97,,176088379,2400647,0,0,178489026,2022-10-31
7ae8b645068f2239,t-mobile,1211952612,22283559,0,0,1234236171,2022-10-31
816582904970ba5a,t-mobile,337093199,32621040,6828,2212,369723279,2022-11-30
b1d01a6cdb80cadb,t-mobile,0,0,0,0,0,2022-11-30
b324470094a27d9f,t-mobile,0,0,65737252,1573787,67311039,2022-11-30
cc803ea8cb8dfddb,at&t,0,0,0,0,0,2022-11-30
30bd2180f74ffc31,,7591849,924754,0,0,8516603,2022-11-30
da335633f5441d9a,verizon,0,0,0,0,0,2022-11-30
14e1999c48cdc8d7,Verizon ,31286586659,523502123,670051,20695,31810779528,2022-11-30
07da48a21fc2cc3a,Verizon,0,0,0,0,0,2022-11-30
a50e85718fca3ce9,Verizon,0,0,0,0,0,2022-11-30
99e418196eee8b3a,t-mobile,868786,350956,191854,64562,1476158,2022-11-30
784ec1df1a5d7a57,,27554,8781,0,0,36335,2022-11-30
1bf99decd47c1531,mint,195841668,2179263,5934,976,198027841,2022-11-30
a9c9c9e237fc0b8b,,454446200,55759756,0,0,510205956,2022-11-30
ffb677465c87ae02,,14715,5657,0,0,20372,2022-11-30
df54d886455748d3,t-mobile,8269011639,205282618,310691,133037,8474737985,2022-11-30
4639c1b3944a0ad4,t-mobile,504993712,48036385,0,2391,553032488,2022-11-30
afcfe493bcc96060,,219318798,5106636,0,0,224425434,2022-11-30
a267a82afd881c8f,,1501150055,24715255,0,0,1525865310,2022-11-30
b957e90aacd86359,,893420,294461,0,0,1187881,2022-11-30
bffd968417809044,at&t,101743765,3553917,337635157,8206067,451138906,2022-11-30
907fca3dc97dfd44,,3227850415,82072973,816980,87828,3310828196,2022-11-30
cabfd2250f435a1d,at&t,0,0,0,0,0,2022-11-30
3e2e4347e2d71d38,,70236308535,1129779857,0,0,71366088392,2022-11-30
ab7d2d3a9397a879,t-mobile,0,0,0,0,0,2022-10-31
7c855c6292aa68a6,verizon ,0,0,0,0,0,2022-10-31
e7778d3393260b68,pure talk,0,0,0,0,0,2022-10-31
d7f78a34b89b7bf4,,603346769,14659780,1909134,459192,620374875,2022-10-31
082523d17b939aaf,verizon ,4304179092,114646382,63368,21344,4418910186,2022-10-31
7b4f266b2572d091,verizon ,5269882181,90957434,1598474,297328,5362735417,2022-10-31
0460236e5cd5869d,t-mobile,2966713425,73991485,11214,5081,3040721205,2022-10-31
ccb755e792b7bd36,verizon ,0,0,19806524,1057353,20863877,2022-10-31
6ea89f10979b0c86,,1171750970,17079828,0,0,1188830798,2022-10-31
2df099327384b364,t-mobile,397270142,8123362,37204,32609,405463317,2022-10-31
4fcf44ccaf46016c,,156996534,5423044,0,0,162419578,2022-10-31
58bf1a36072a52d4,,409815,153046,0,0,562861,2022-10-31
b63754736582bbec,t-mobile,0,0,0,0,0,2022-10-31
9960230681ddcc24,t-mobile,591120630,38395630,54726,19397,629590383,2022-10-31
5acbf1330c2b4a14,at&t,0,0,600245,209801,810046,2022-10-31
41904ecac4e14888,t-mobile,0,0,0,0,0,2022-10-31
3ec1803226850517,,197871,47266,215750,76933,537820,2022-10-31
99b9a37a8df3bb45,t-mobile,10738812339,170609118,0,0,10909421457,2022-10-31
bee033c1859bbce8,at&t,0,0,0,0,0,2022-10-31
6d28d87c2cde7d6f,t-mobile,0,0,0,0,0,2022-10-31
bb4e8cf64ba6d1f3,t-mobile,303475078,11718807,0,0,315193885,2022-10-31
051b4a5dfcc32d02,t-mobile,227718097,3477723,140258,38752,231374830,2022-10-31
a8e72f81c2b9384a,,19608211,357871,0,0,19966082,2022-10-31
9dd564b2f01a6220,t-mobile,0,0,0,0,0,2022-10-31
b4c14a8fd7e18a15,,718296,185754,254196,90060,1248306,2022-10-31
c788417e6427570e,t-mobile,26134054124,477277630,172156,90887,26611594797,2022-10-31
4a91ee4f6cdc1a18,,703453,254613,18971149,823545,20752760,2022-10-31
93dfa7f4d72d552e,t-mobile,0,0,0,0,0,2022-10-31
7c7eb0fa1f8a0759,t-mobile,808483100,55923913,0,3133,864410146,2022-10-31
8095c5e6ea9ce261,t-mobile,0,0,0,0,0,2022-10-31
348d94c4c4453a84,t-mobile,839834342,46555914,25110,11643,886427009,2022-10-31
4d8ccb64194e013b,t-mobile,453897035,43037575,351332,120377,497406319,2022-10-31
a726a6b77c4a0204,,6525812941,123439074,0,0,6649252015,2022-10-31
ecd0fe066b5c19e8,t-mobile,730714,240706,0,0,971420,2022-10-31
5ed76cf57c75e271,,816298,224224,0,0,1040522,2022-10-31
a7d5959b5d250ad1,home,61623,511389,139531662,3129613,143234287,2022-10-31
ae86c62b2bfb6721,t-mobile,29361260082,484928950,145354,52630,29846387016,2022-10-31
74711624d0c7446c,mint,1176611269,41677778,1116270,196572,1219601889,2022-10-31
11c9702478ee071e,,80490894,1890156,0,0,82381050,2022-10-31
cee414e74cb52849,mint,2050578411,59402629,0,0,2109981040,2022-10-31
da1e7e5eb994b4e9,mint,684494851,51888290,1871020,281341,738535502,2022-10-31
ea63da3aaa3812b0,mint,426207582,33392151,1022184,174998,460796915,2022-10-31
41703ad26acf8d4f,mint,1653518230,38084501,170191,59602,1691832524,2022-10-31
aa2d0e49254603da,at&t,1224212624,49173408,60953,29558,1273476543,2022-10-31
8c3c519a0dfffd0e,verizon ,1744600805,84346707,6742,1279,1828955533,2022-10-31
bc97d69bdf97c729,verizon ,1982394358,70473510,96405,36098,2053000371,2022-10-31
37f84f00c6c8e275,,1151186451,49902525,0,0,1201088976,2022-10-31
05316eecc34e97d8,at&t,813070442,68940954,1132377,172194,883315967,2022-10-31
ab9d898e3ef24df6,verizon ,2767331242,57627744,1098609,193592,2826251187,2022-10-31
d0362ae13fc63dd9,verizon ,953155714,99405096,801255,85884,1053447949,2022-10-31
6ef47aaa52a8b82a,,841481890,38720573,0,0,880202463,2022-10-31
26cc08559a666d90,,162030987,2920979,0,0,164951966,2022-10-31
37d1a076722cb8b3,,154556194,1904939,0,0,156461133,2022-10-31
de116045891cbed0,,154635090,1398642,0,0,156033732,2022-10-31
6b77292a2c8f354c,,287817108,4090186,0,0,291907294,2022-10-31
5541fc4d3c065400,,155139397,1909517,0,0,157048914,2022-10-31
503a551c9a651a4b,,154780856,1317131,0,0,156097987,2022-10-31
ede5a6e94584d615,,155165109,1825133,0,0,156990242,2022-10-31
abd382a6281dd409,,154365319,2208381,0,0,156573700,2022-10-31
09af1188e0abee15,,154400615,2058002,0,0,156458617,2022-10-31
bd21670364e0aece,,1595825300,20575376,0,0,1616400676,2022-10-31
0e25cd4d6855a5db,,63864044,1876797,0,0,65740841,2022-10-31
d30e6fcefb6b86de,t-mobile,43197386979,700891945,1017644,175431,43899471999,2022-10-31
7f1acb6f61ff5ca2,mint,1255843770,25811990,1159521,78894,1282894175,2022-10-31
191c37497fff55ac,,237425976,5469103,0,0,242895079,2022-10-31
b6c4fc899397c7a3,t-mobile,1258709356,49999818,20618,4445,1308734237,2022-10-31
455f0f9952bc3831,mint,1993088143,55052609,0,170,2048140922,2022-10-31
bed55b6b018d554b,Â ,979820770,30443502,84,84,1010264440,2022-10-31
9d7cd8c2fd4f971d,,66677037,1718260,0,0,68395297,2022-10-31
6aae4aecc7be53db,,288456534,3834817,0,0,292291351,2022-10-31
f2ae0f91cca40fb7,,164975162,3276179,0,0,168251341,2022-10-31
671b615cd472f2d2,,169654619,3279258,0,0,172933877,2022-10-31
83eda18c7813a949,,382390532,2426123,0,0,384816655,2022-10-31
7398888d77e86200,,265861121,4333868,0,0,270194989,2022-10-31
56b48754d39b7547,,108518772,4005852,0,0,112524624,2022-10-31
ef2d288af0c8847e,,88800034,2456115,0,0,91256149,2022-10-31
2eb96cd95f9d92da,mint,362506081,11625663,1536385,176752,375844881,2022-10-31
6b1e10b356741768,,170127590,2116342,0,0,172243932,2022-10-31
28f0f8651c2e6f74,,169844111,2089018,0,0,171933129,2022-10-31
246c10494a985f85,,49143944,1770571,0,0,50914515,2022-10-31
77124d0c2341717d,,170109053,2686202,0,0,172795255,2022-10-31
2d9b66608c6ddaf8,,1002350267,17413116,0,0,1019763383,2022-11-30
fb5aeea72a2c5a75,t-mobile,583005,255008,0,0,838013,2022-11-30
55fe1a21c2301440,t-mobile,0,0,199236312,5762158,204998470,2022-11-30
e3299e04704fc182,,91005258,2716671,0,0,93721929,2022-11-30
21d5b9c1b5e5d392,home,854318,259278,0,0,1113596,2022-11-30
67baf0215d61a256,t-mobile,0,0,0,0,0,2022-11-30
25c34ff52599c8f1,verizon ,22234969,3257352,1178443,282470,26953234,2022-11-30
49b38d46a4d1dd3d,verizon ,1214092377,106165926,928180,115560,1321302043,2022-11-30
779803e3c757de6a,Verizon ,783048920,11415137,125865997,3688645,924018699,2022-11-30
8c05a46e734f05aa,verizon ,216462774,3940758,311023,100750,220815305,2022-11-30
9ebf73f72b483876,,826278,291870,0,0,1118148,2022-11-30
da2e28f0f2937c63,t-mobile,0,0,0,0,0,2022-11-30
8ecf1ae70953f508,mint,76954932,1955252,100920,31549,79042653,2022-11-30
479852624dd237d2,,897918050,20674755,0,0,918592805,2022-11-30
cc3e12dc1362a37e,t-mobile,455102196,58243781,13058,4625,513363660,2022-11-30
3754029f1ee576e0,t-mobile,0,0,3875549,354457,4230006,2022-11-30
fc2def0a62f3ea33,,183800224,3257033,0,0,187057257,2022-11-30
ce5c8f232989f5be,cricket,0,0,537605,178305,715910,2022-11-30
e9ece0dcbf332ecf,t-mobile,330718681,25647192,703226,82004,357151103,2022-11-30
042e5dfa23922f4a,t-mobile,36761938158,581972167,683140,40821,37344634286,2022-11-30
06ecbd2603eadda2,t-mobile,0,0,1235513,203669,1439182,2022-11-30
7224fb9f21ef7d31,,493070067,9611900,0,0,502681967,2022-11-30
195d7af07c4d3460,t-mobile,12590190827,232388232,1595011,142097,12824316167,2022-11-30
875436e8acfca35a,,437348071,28239104,11228,2665,465601068,2022-10-31
f6b6c0090c9126c4,t-mobile,13628237542,273415342,1318028,110085,13903080997,2022-10-31
aedfa7aac441f035,,1375761273,26609589,0,0,1402370862,2022-10-31
8b6ac329781248a8,at&t,671483,212852,198720,221421,1304476,2022-10-31
7416fa6e955a0adb,at&t,0,0,0,0,0,2022-10-31
b19ae8cf0c34ed0a,verizon ,1040565,407790,102338,55407,1606100,2022-10-31
d9d0d1ef42c3a3d4,verizon ,0,0,770489,304417,1074906,2022-10-31
3a5bc83ba4a44f81,verizon,0,0,0,0,0,2022-10-31
d17fa77efd0ddd46,verizon,0,0,0,0,0,2022-10-31
aa1208829e90487e,verizon ,0,0,1217872,308606,1526478,2022-10-31
397b17397fdc357a,,4156749529,71709389,0,0,4228458918,2022-10-31
d17292be75980f6d,,88652332,3076093,0,0,91728425,2022-10-31
4c09439e7212e674,,196592136,3459736,10908,107659,200170439,2022-10-31
97f7d568908654f3,t-mobile,831207,293906,244959,89599,1459671,2022-10-31
cc08ab646744fac7,t-mobile,476964,139103,0,0,616067,2022-10-31
b0f1cdc3df6aca55,t-mobile,0,0,0,0,0,2022-10-31
35ffa76050874ef7,,29918481,4896396,0,0,34814877,2022-10-31
d6ef1d3b9455db1e,at&t,882695,279691,19472,7571,1189429,2022-10-31
39be7c6d7e8a84dc,,3955571815,100436554,6600,1948,4056016917,2022-10-31
153b731dcdef29a5,t-mobile,443237,319703,709341,276209,1748490,2022-10-31
3d18d57fe69ab110,,9646821,633747,3967960,242907,14491435,2022-10-31
6c0e3a9c2538bae9,,2102896827,107172804,28134,9616,2210107381,2022-10-31
802a7ad0eff27bf7,t-mobile,688957631,10285077,35731,11037,699289476,2022-10-31
a5df8616cb4310b6,t-mobile,1556166526,100407341,29382,9727,1656612976,2022-10-31
5f167c4a02884d57,,537619,126417,0,0,664036,2022-10-31
e603f77df98d7e22,t-mobile,840042,268532,0,0,1108574,2022-10-31
c9e1d08f748dde86,mint,0,0,0,0,0,2022-10-31
43ae205542a2c9e2,,164669912,3289516,0,0,167959428,2022-10-31
3339641bd5b943ca,t-mobile,763539,254178,0,1312,1019029,2022-10-31
3c03a2eee6937a56,t-mobile,0,0,0,0,0,2022-10-31
02a7b5f7272b812e,,655231,203209,52247,14370,925057,2022-10-31
d459957255adba8b,,132278278,3258933,0,0,135537211,2022-10-31
e8b424241788e0d0,t-mobile,120007,33811,44650,12576,211044,2022-10-31
9211d80bc733c35a,t-mobile,0,0,0,0,0,2022-10-31
00a245b497a142a8,,885760,301682,725107,299010,2211559,2022-10-31
556dfce4febd09ae,t-mobile,581149023,36722743,145654,48112,618065532,2022-10-31
d8fc37ceb5c86eb5,verizon ,2261815424,39656970,0,0,2301472394,2022-10-31
92d3ba8bcc716ace,t-mobile,12667516,1382553,588330,200539,14838938,2022-10-31
be25df92a9e97c68,,7590612522,115288363,0,0,7705900885,2022-10-31
9905cfcf6e6532bd,mint,1412137907,81488685,1076313,266235,1494969140,2022-10-31
90efa9deda8372ac,verizon wireless,0,0,0,0,0,2022-10-31
34e20eeb1ae73bf4,t-mobile,1005837412,53226552,1826589,258856,1061149409,2022-10-31
0989b6a431ccd03a,,132032168,3001448,0,0,135033616,2022-10-31
cb6990e1b2a49525,verizon,0,0,0,0,0,2022-10-31
33be468856986b82,,3991348,338663,0,0,4330011,2022-10-31
c2cad2ab6d32e997,,617500,183655,69540,26404,897099,2022-10-31
17ae28e3cda454b9,t-mobile,0,0,159643788,3946771,163590559,2022-10-31
d5258fbb1b619457,t-mobile,36865857,1085816,39747887,1565266,79264826,2022-10-31
07d3ced529a654f6,t-mobile,0,0,1083834,288833,1372667,2022-10-31
d63131001322c318,t-mobile,2120576381,54164034,0,0,2174740415,2022-10-31
6191ce8c25c6e35c,t-mobile,0,0,510877,33124,544001,2022-10-31
9db2d4e0a68bf5f7,,764177506,30368294,0,0,794545800,2022-10-31
661214bf89b4a596,verizon ,323680719,40408926,1116201,211378,365417224,2022-10-31
d7eaaa5605fc686b,at&t,630746,216741,82411,28781,958679,2022-10-31
5d7313bdf71e8c13,,540189,137950,296604,77054,1051797,2022-10-31
6400d83e9e032197,,1152556,243576,0,0,1396132,2022-10-31
0983bedf0dbddbdc,cc network,0,0,0,0,0,2022-10-31
80de9fcf520b1378,at&t,76921201,1368235,20537895,1504728,100332059,2022-10-31
76c2695de3f664a4,t-mobile,758273774,60595135,34670,34764,818938343,2022-10-31
e0235cf767d63ab7,wireless,4281728596,156234037,628725,23675,4438615033,2022-10-31
c83b8887684372c9,,1252477,195569,817835,143223,2409104,2022-10-31
d235d84cb127a03b,t-mobile,370248905,25895972,700191,62822,396907890,2022-10-31
59f2cfbdab855d71,,43110635,884308,0,0,43994943,2022-10-31
e1b107742a8346b0,t-mobile,5203606154,131778743,621737,22930,5336029564,2022-10-31
79befed781af2903,mint,926258259,95113098,95471,39873,1021506701,2022-10-31
453bd174f71b44da,,9674696841,193671406,0,0,9868368247,2022-10-31
488b76ca76e1a21a,t-mobile,620455568,62217844,15,21,682673448,2022-10-31
def214b1dfea7946,t-mobile,13351539689,271048235,371,6620,13622594915,2022-10-31
9aebcc8484896977,mint,808644615,108999695,418,444,917645172,2022-10-31
6d50e91f16fdf0b4,,885589,296117,7604,2030,1191340,2022-10-31
45e6bd1a161e99bb,t-mobile,119667237,2229893,11663,5365,121914158,2022-10-31
1ae67f61c7dc6c51,,148182018,2390605,0,0,150572623,2022-10-31
ec4c2badf68cd50c,verizon ,775097916,31547665,1409836,298111,808353528,2022-10-31
356bf3f78acc1b27,,13942,3282,0,0,17224,2022-10-31
f3fb84999276be30,t-mobile,745214,239029,864258,289247,2137748,2022-10-31
f4a44c00045c206c,t-mobile,1833094614,67668593,51649,18702,1900833558,2022-10-31
791850c3fbfba120,mint,689908243,31941476,184183,80012,722113914,2022-10-31
8560cf789cb776ee,t-mobile,715592800,44097248,36131,12032,759738211,2022-10-31
16cbaaf7b8a6ce8b,t-mobile,652315,223539,229173,63647,1168674,2022-10-31
374982bc4a3ba828,mint,178845124,15956411,104,104,194801743,2022-10-31
bd4f04c9e52880d5,t-mobile,798249263,59053741,25769,15568,857344341,2022-10-31
7587871f180ed93b,t-mobile,48684,127258,0,0,175942,2022-10-31
f7c038853a56a798,t-mobile,384249,144354,548943,190609,1268155,2022-10-31
f2b9399427644828,,776252266,44618627,8422,4150,820883465,2022-10-31
a7ff9e72454a8ffc,mint,323613168,15555168,104,104,339168544,2022-10-31
57283c5b2286c93c,verizon ,0,0,723618,267518,991136,2022-10-31
c4882828493ec409,verizon ,1432795083,81357373,1844486,269045,1516265987,2022-10-31
707c6bc88928ffe0,,1088193801,53684072,522,354,1141878749,2022-10-31
256cfa26817cfdc0,verizon ,5425569870,137200511,112958,42396,5562925735,2022-10-31
deac46aee7c3f6c6,verizon ,30283109616,533533593,151516,53134,30816847859,2022-10-31
ee4c31d27da016fc,verizon ,636490,249653,650262,310588,1846993,2022-10-31
aa6ed5a0f00d2392,,131851493,15197861,30059,339753,147419166,2022-10-31
9060b64f25773593,at&t,159018588,2280857,31999,10846,161342290,2022-10-31
51260fd00c0bdcbc,verizon ,0,0,788411,281720,1070131,2022-10-31
9b1ff5cff12c817b,,474397908,49197692,0,0,523595600,2022-10-31
1fb0ea692980fdbe,mint,0,0,1346313,364841,1711154,2022-10-31
141c8b93e84533d8,mint,90318346,14109679,0,0,104428025,2022-10-31
f3f73f496f8bf5cc,mint,0,0,0,0,0,2022-10-31
0a2aa23838f8555c,t-mobile,978557702,68667232,0,0,1047224934,2022-10-31
d08a05efd72901fa,mint,2359688787,75256525,1673222,219620,2436838154,2022-10-31
3430db43bb635aa6,mint,84968312,1723361,438618,280739,0,2022-10-31
55a279fb690ef6ae,t-mobile,863386,257535,493537,170224,1784682,2022-10-31
0604ec5c4b7ca40f,,310216900,8606780,0,0,318823680,2022-10-31
fdaeebd2cc3b967a,,104949110,2964968,0,0,107914078,2022-10-31
281dcdd1cc22c6fc,mint,1272843344,73569887,0,0,1346413231,2022-10-31
e4f3f8c913431ad4,t-mobile,1011591257,63889059,6935,2284,1075489535,2022-10-31
ad777e0f1692c9e6,,718936,209717,260502,83466,1272621,2022-10-31
0dd49b3d462ab8c3,t-mobile,1262753,570984,0,0,1833737,2022-10-31
a6def015cbc450ee,verizon ,675421254,60814924,16278,8729,736261185,2022-10-31
ecfcc94566cb320b,at&t,490234827,47689907,0,0,537924734,2022-10-31
9d4d4e824e547d71,t-mobile,782353355,13771438,16424,353058,796494275,2022-10-31
504a906d889f5bdd,,184495393,3268778,0,0,0,2022-10-31
2eb5f5956313cf0d,mint,486626069,40439527,37404,24023,527127023,2022-10-31
029ca9b9c1a2b08a,verizon ,0,0,923074,176299,1099373,2022-10-31
fcd843786e479a6c,at&t,724127,220516,122403,64163,1131209,2022-10-31
a1bc5bbd22b083b3,verizon ,414299941,22578101,627437,34792,437540271,2022-10-31
6e4e2da823784c67,verizon ,12179646600,263812793,34175,10914,12443504482,2022-10-31
c57d8fedafcfdb34,mint,19694,7006,3987567,535018,4549285,2022-10-31
df3d44d9aef33020,t-mobile,442629718,8140036,1034405,197923,452002082,2022-10-31
87ebcbb0844f1a7d,verizon ,13906251094,272345592,1132939,204445,14179934070,2022-10-31
f246c5fdd5128fc3,mint,416438229,30645868,15124,2579,447101800,2022-10-31
c0c20310a4ea3eef,mint,249159943,16619879,1576390,361607,267717819,2022-10-31
9e48caf20bc85893,t-mobile,223148767,2347176,0,0,225495943,2022-10-31
b9326996cd52c826,,13423753,1554684,0,0,14978437,2022-10-31
2d457d9f6b1ae001,t-mobile,283953,101454,822621,296693,1504721,2022-10-31
8a4fe5ebcf06ea23,,155030115,2242248,0,0,157272363,2022-10-31
6b2d82feb05fef5e,mint,1092938468,83484423,415028,50216,1176888135,2022-10-31
9b77bca61fcf4ea4,,390370077,6118474,0,0,396488551,2022-10-31
c36ed05bcfddee36,mint,48352,25051,1057122,124354,1254879,2022-10-31
b89b6030f1fc2e05,t-mobile,728697,228347,109697,25756,1092497,2022-10-31
389033ac3555ba79,t-mobile,0,0,17233,3936,21169,2022-10-31
e96d175f3dc10ed8,home,661205,194947,276177,92874,1225203,2022-10-31
2367996d9e048397,at&t,699143,206051,2095,36041,943330,2022-12-31
32b10f643f4fc27d,t-mobile,903996514,56557804,22045,11142,960587505,2022-12-31
bdbdbb4e8a55b159,u.s.cellular,936598,301661,0,0,1238259,2022-12-31
432312e400ab0281,mint,2708594402,32512230,772530,266682,2742145844,2022-12-31
0aed615b547fc1ec,mint,704536,206402,160189,60439,1131566,2022-12-31
3244585597dd3b08,at&t,746920745,41259914,14203,4299,788199161,2022-12-31
b48ec3e723e5d9ce,,1067373440,13105557,0,0,1080478997,2022-12-31
0273d3ef8f534ac0,,198429827,27403857,0,0,225833684,2022-12-31
902c3e7a0f406696,at&t,886547,375112,271034,123252,1655945,2022-12-31
3b59eae0b845601e,mint,0,0,40212508,1802794,42015302,2022-12-31
ed0d310d7cd99863,t-mobile,796819,289730,82240,33045,1201834,2022-12-31
d23c5bff0b952b78,t-mobile,220762250,4671323,0,0,225433573,2022-12-31
2f802a7c301a4193,t-mobile,564570856,6783735,104,104,571354799,2022-12-31
0b3afcd478e67a17,,332624995,11785324,0,0,344410319,2022-12-31
e5bbb5f8bb1fdc85,at&t,734159,236421,7010,1948,979538,2022-12-31
34f5573ce45228c1,mint,467765549,7144022,0,0,474909571,2022-12-31
c8ee1b2d03a257eb,red pocket,778154219,73981412,2066334,269617,854471582,2022-12-31
68c6dde170a88c4a,t-mobile,99188355,1737630,81557,865982,101873524,2022-12-31
98b4c0721fa5193d,t-mobile,1145951570,83806493,190600,16213,1229964876,2022-12-31
8d0858ef90da09a3,mint,51673638,857072,1206,19248,52551164,2022-12-31
6b0a750ff07ba8f9,t-mobile,3791675238,52146526,0,0,3843821764,2022-12-31
68edb3ab27349de3,t-mobile,32220749,898587,0,0,33119336,2022-12-31
4d4556c218b44307,t-mobile,197423,397864,0,0,595287,2022-12-31
8107c1acd4b3dae1,,274811639,4032722,1197704,229931,280271996,2022-12-31
754dc503863763a7,mint,836214,247458,50765,19090,1153527,2022-12-31
a5cb2611e23a6171,,73581245,1514856,0,0,75096101,2022-12-31
71d5d3b715fd7e39,mint,796446,272661,0,0,1069107,2022-12-31
8782b8eefba7c92e,t-mobile,937592721,35196132,0,0,972788853,2022-12-31
0d4e65ea177a5c1d,mint,580989081,48606410,619,1720,629597830,2022-12-31
ac0495cd99fa5e65,t-mobile,874765038,72401890,72800,12862,947252590,2022-12-31
35ac7628bc704470,mint,715301332,40159362,0,0,755460694,2022-12-31
70c885f4ab7ff04f,mint,484370,152513,90257,27395,754535,2022-12-31
050ca259bb2b6fdc,,2581186017,44361984,0,0,2625548001,2022-12-31
5b72e69888a71914,t-mobile,634737,182332,0,0,817069,2022-12-31
acf552ee295b60ab,mint,591239620,17751661,0,0,608991281,2022-12-31
6066827ac162066c,,19142580,1051135,0,0,20193715,2022-12-31
2c127eda7f012606,,22144,8924,0,0,31068,2022-12-31
2cb02d98eb582d38,,1031033824,29517233,0,0,1060551057,2022-12-31
c6f6327d014e7ad5,t-mobile,177658,49042,16241,4032,246973,2022-12-31
febb14a9553945c4,,410457841,5087190,0,0,415545031,2022-12-31
b3b9379a98158c0d,t-mobile,2860817985,89911375,742491,30054,2951501905,2022-12-31
440122e817af203b,,73509721,1099593,0,0,74609314,2022-12-31
7d6c74ab9e8e4b41,red pocket,668237006,58645580,313078,71666,727267330,2022-12-31
6e36fb07f29d4cef,t-mobile,403080095,35073112,1546414,301385,440001006,2022-12-31
3c5f584f0100a59c,mint,689994930,12098394,738828,39276,702871428,2022-12-31
3f6ec29a2d7e521e,verizon,1412853,236351,0,0,1649204,2022-12-31
5b65e60433689c13,,15639896612,230262200,20746,7226,15870186784,2022-12-31
f3d533c83f4995c9,at&t,120503208,1571240,123095,137692,122335235,2022-12-31
b49308b522df1ff8,at&t,192654185,4297392,0,1736,196953313,2022-12-31
ee3a2f2f70dc396a,mint,934397163,75904198,6744,2127,1010310232,2022-12-31
866d7e0b56c4773f,mint,547008,221532,963738,295663,2027941,2022-12-31
50d4d06fb198f406,mint,7426309024,130149895,636464,27446,7557122829,2022-12-31
9e5f54b2cccb1f29,mint,56271,124882,50337,13769,245259,2022-12-31
723b8cf5220f4a6e,t-mobile,265736,78417,86760910,4103592,91208655,2022-12-31
9e2eb6a99c9d85f8,mint,9466356,250764,71116033,1975254,82808407,2022-12-31
13dece7e56c45cd8,,122090746,15250267,55476,17487,137413976,2022-12-31
169073d763b68707,mint,771302,221917,35384,397892,1426495,2022-12-31
085ab311d7c863b9,mint,96040900,3612120,218,3922,99657160,2022-12-31
29725c98d02dbdbc,mint,167389812,18454302,1531878,90785,187466777,2022-12-31
a6ba6a9b2734b98b,,940980064,62180981,4828,2413,1003168286,2022-12-31
8b01371a0ddbcb45,tello,982123733,64297155,3750,34306,1046458944,2022-12-31
6da17f268f61d1b3,mint,791332365,58187777,60,4147,849524349,2022-12-31
a843829545e92c00,mint,151016,45164,7849,2676,206705,2022-12-31
94eb27220bbcb549,mint,476804840,8695972,0,0,485500812,2022-12-31
aadd4820070b2247,,46733,8413,252803,119089,427038,2022-12-31
fb8ae447715f940e,mint,696159198,43431811,45963,137359,739774331,2022-12-31
6799b2eb33248ecc,mint,731984,242946,0,0,974930,2022-12-31
8755763a3eb110aa,t-mobile,266416614,6476235,609187,605050,274107086,2022-12-31
3df8cd0ea5452a0c,t-mobile,1539549247,68203958,1461767,97055,1609312027,2022-12-31
058546c6d0fee4d6,t-mobile,0,0,30761951,781967,31543918,2022-12-31
aa8bb96f066a1d48,t-mobile,1080099182,65245463,790868,176878,1146312391,2022-12-31
e261f2582dcdeb10,,744569579,6869038,0,0,751438617,2022-12-31
745498ff5e83a0bf,mint,552361559,67771093,387678,16694,620537024,2022-12-31
3e5c18e79db5bc0b,verizon ,22656614745,454483064,102518,36562,23111236889,2022-12-31
0ecaff67912aca6a,verizon ,327529845,23817338,1382005,67870,352797058,2022-12-31
b669f53071fae212,verizon ,645427343,4374046,870932,83535,650755856,2022-12-31
66a9ec7a3adc5352,verizon ,1458415175,74662312,1451114,51526,1534580127,2022-12-31
4e005d796092a55c,verizon ,1246461244,59493297,1463054,32933,1307450528,2022-12-31
b5dbb027b09e2962,verizon ,1442180127,35879481,804506,82867,1478946981,2022-12-31
be8502fede9d825d,verizon ,1244372065,53780122,1446854,31095,1299630136,2022-12-31
6c4fe7c5e9cd50fb,verizon ,480257005,34830848,90044,29190,515207087,2022-12-31
0242c70eaff1a20f,verizon ,914659681,85055750,1464732,38811,1001218974,2022-12-31
b896bc9be17760c1,,74517314,1330417,0,0,75847731,2022-12-31
fe0eb80cccda4519,,917214714,38104034,61130,24249,955404127,2022-12-31
bad1d18c7c5e97ff,mint,1293247997,88334882,34423,28571,1381645873,2022-12-31
4d5d3d4ad5a18abe,,74518758,987688,0,0,75506446,2022-12-31
2c1cf27690af7dd0,mint,41745009,2347019,803765,938668,45834461,2022-12-31
89b17cda6b35d7a1,t-mobile,1389043,233509,286891,101259,2010702,2022-12-31
9f188ed4a0ec25d8,,280497621,6270833,0,0,286768454,2022-12-31
a86f42e7ef19c7f2,mint,206611043,3528103,2245,4216,210145607,2022-12-31
af17aef87c343fae,at&t,661103514,35174164,678226,40757,696996661,2022-12-31
6dfff6c9e3d281d9,t-mobile,407113091,35342882,457,153,442456583,2022-12-31
73c4eeab2eea9f2e,mint,589131933,21686205,104,104,610818346,2022-12-31
2bd7b83dbde102da,mint,4634807357,111310448,731114,338999,4747187918,2022-12-31
ca866fcb2cbfe5dc,mint,1729797273,27651777,34572,8408,1757492030,2022-12-31
99acd7c68a3f241f,mint,321307593,13277582,162317,46717,334794209,2022-12-31
3397f18c5cc8488c,mint,657511166,56358125,7731,2724,713879746,2022-12-31
cef90cefd22d8e7c,t-mobile,614427504,29848771,0,0,644276275,2022-12-31
0d9561dcc6772031,mint,347588057,4526776,46047868,1785711,399948412,2022-12-31
16ba2beccaa32605,,1060211748,48423083,0,0,1108634831,2022-12-31
429340edf156b1e0,,1082810,318226,0,0,1401036,2022-10-31
7cec14de72400b68,t-mobile,126564232,3776278,1586,21567,130363663,2022-10-31
1eb4cf2b320265c2,t-mobile,78120,26590,1067014,405801,1577525,2022-10-31
aab7628f15c28300,,1221586071,63006921,593080,200026,1285386098,2022-10-31
d7ba3c6c50a302e4,t-mobile,0,0,0,0,0,2022-10-31
f11f4190e2b4f251,at&t,834653,236354,7592,1978,1080577,2022-10-31
9e7f786c7da1498e,t-mobile,0,0,0,0,0,2022-10-31
aa9d65642124993c,pure talk,803297,254806,0,0,1058103,2022-10-31
744d59155bb74790,t-mobile,260418,736299,11427,1954,1010098,2022-10-31
f6ce52053a2e54a0,verizon ,0,0,316321960,3357802,319679762,2022-10-31
a31ff16abd9412d1,,2334331173,67414227,0,0,2401745400,2022-10-31
6d5da0d1f173a512,t-mobile,527831256,39898813,1092627,205445,569028141,2022-10-31
be7ed1874c65e92f,,877784,358707,729430,308288,2274209,2022-10-31
813e1eb117a1b50c,t-mobile,0,0,709928,63975,773903,2022-10-31
bbf0dfcff89c68aa,,1676708348,30515875,0,0,1707224223,2022-10-31
c9c335dd77f99434,t-mobile,703266537,29234122,805,5722,732507186,2022-10-31
8222e27ca383b818,verizon ,475755039,63227688,48133,15083,539045943,2022-10-31
8e51b6010d66a0b5,t-mobile,0,0,380001,111522,491523,2022-10-31
41b7589741c04448,,57374761,2990962,0,0,60365723,2022-10-31
158a87757afd53c6,t-mobile,702255,185273,129825,39591,1056944,2022-10-31
c5e280c00219d01d,,480469,143832,0,0,624301,2022-10-31
e494db982e954d0a,at&t,44229,192430,0,0,236659,2022-10-31
2b8f9a036d9f0bbf,,1299716548,21628903,0,0,1321345451,2022-10-31
f4620269c9ccfc0d,,726171,407201,307454,118985,1559811,2022-10-31
cf742c97c9f7ecbb,t-mobile,1154420557,66733407,13979,4496,1221172439,2022-10-31
be7929447cf8b6e4,verizon ,0,0,433384000,6297164,439681164,2022-10-31
28d647074ffb5623,,3259191945,78544556,0,0,3337736501,2022-10-31
1b9aabea1aabb85b,t-mobile,799235573,52239914,6853,2271,851484611,2022-10-31
f458b190e9a9fd1a,t-mobile,720253,193197,154229,49388,1117067,2022-10-31
888d47d65bcbe355,,4651545,126713,136784343,1780728,143343329,2022-10-31
faddae6d194ad2cc,,709440,239890,183699,68785,1201814,2022-10-31
fe7941716f448048,t-mobile,131238075,3557523,39308,797333,135632239,2022-10-31
b8b12c21e55b7460,,33376,6976,0,0,40352,2022-10-31
f3f72fabdc0c045c,,145919959,4389909,0,0,150309868,2022-10-31
4d8fd7e71cc281bf,,1901018424,37644191,0,0,1938662615,2022-10-31
e13d5f2fa74f1247,mint,816078703,73151790,74221,37137,889341851,2022-10-31
602dabda85b452df,mint,412576989,33594134,15568,6341,446193032,2022-10-31
f3ce1e1dfb873a0e,mint,0,0,1305746,87279,1393025,2022-10-31
4774dc0acba254f9,verizon ,649155522,68785197,71884,25098,718037701,2022-10-31
90edf6ec341b903d,mint,3035748469,67339858,1009933,66124,3104164384,2022-10-31
e445312ab744f36b,t-mobile,0,0,0,0,0,2022-10-31
cdd67e4412af41f1,metro by t-mobile,845494530,77172067,135067,54920,922856584,2022-10-31
6d0f1369118effd7,mint,0,0,0,0,0,2022-10-31
545c7df989d7d3da,t-mobile,490927307,64248661,4652,42719,555223339,2022-10-31
e9bee3db75523f1c,verizon ,7298816310,183650122,63630,19270,7482549332,2022-10-31
a938b16bdf9009f9,verizon ,4288304908,98923850,774461,79054,4388082273,2022-10-31
1ff17e00da9c2182,verizon ,753261061,12619320,594833,82781,766557995,2022-10-31
8ca8c04302b9aac1,t-mobile,0,0,1197288,228677,1425965,2022-10-31
fc3cb6ed6ed5fad2,mint,254221,74325,218,823,329587,2022-10-31
95a81c36190684a1,t-mobile,321577227,29230950,29776,248479,351086432,2022-10-31
db0241cbdc68d515,t-mobile,190600331,3870596,119545,38119,194628591,2022-10-31
286127b08dadeef6,t-mobile,573144,175649,22674,213268,984735,2022-10-31
0d9a0490d17b0fe1,mint,679032,380220,790870,327173,2177295,2022-10-31
c59b0c6e5bfec8f5,t-mobile,0,0,0,0,0,2022-10-31
0e909c8cb5d5a372,t-mobile,953668252,66893692,104,104,1020562152,2022-10-31
4006bb4591edb1cf,at&t,0,0,0,0,0,2022-10-31
68c36c0b78c2b42a,mint,939710200,50523278,80856,59702,990374036,2022-10-31
e5d9a4bc8d496ed8,verizon ,5380336693,102586812,1104950,251063,5484279518,2022-10-31
a854fff0278f4f27,verizon ,0,0,0,0,0,2022-10-31
8a215e7eef9f35e6,verizon ,865637,256260,0,0,1121897,2022-10-31
4fcf5402c4720982,,785772,218675,822716,246083,2073246,2022-10-31
c54c555b249ac105,verizon ,485020661,43956342,1845658,272003,531094664,2022-10-31
5d2684d470564c31,verizon ,521602,46505,14094132,1633759,16295998,2022-10-31
93db50c360516574,,785167,242726,445938,132739,1606570,2022-10-31
0459a59a5ab0d133,,663639,176401,0,0,840040,2022-10-31
b69fc0aa8336cdea,,580818496,25975045,0,0,606793541,2022-10-31
003ad1e7ce0ddeec,verizon ,4174415509,67343377,194790,66440,4242020116,2022-10-31
99fbcc904b9a3530,,936366,290728,0,0,1227094,2022-10-31
d6f9e33402880f18,mint,762105743,36652556,14811,5315,798778425,2022-10-31
39d71e79924cb7cb,,172551327,1999460,0,0,174550787,2022-10-31
cb2b5f91db566f8b,t-mobile,1714732180,56586424,60001,19044,1771397649,2022-10-31
0b98ff8a3db7e5f8,home,838602,274096,7825,2489,1123012,2022-10-31
d87602b400bba1ec,t-mobile,80597,139164,476872,194451,0,2022-10-31
077e99b41f7542a4,t-mobile,120425147,2396538,7188,2045,122830918,2022-10-31
e031104c90e9f8e1,t-mobile,4662394,2321239,640359,137696,7761688,2022-10-31
a4c458b642b43667,mint,203268992,2575924,0,0,205844916,2022-10-31
3db4136432befd50,verizon ,436147764,8439976,1022,18931,444607693,2022-10-31
bd0e250a2d57a94d,grameenphone,4379363,736784,0,0,5116147,2022-10-31
28dabfac721a01a2,,182865,55083,0,0,237948,2022-10-31
ffc063517c63f5d9,,52323453,1364334,0,0,53687787,2022-10-31
170dd0c89c74c2cb,mint,1285693069,13920476,131039676,3104415,1433757636,2022-10-31
fd723c939d3fb6c0,verizon ,57664802094,948958047,296420,29095,58614085656,2022-10-31
5ec1031df9eba0c4,mint,752322848,31758677,709331,71140,784861996,2022-10-31
9aea197cd9e17c62,mint,4127554512,113607057,7044,2441,4241171054,2022-10-31
8be80f7541ee53d6,t-mobile,37732,130736,8630,2424,179522,2022-10-31
9af4461647353526,mint,40696,128378,1024,4824,174922,2022-10-31
90889311d2eeb45a,,954474749,13304857,0,0,967779606,2022-10-31
23f55999c7cde2ba,mint,154040,178417,688528,249024,1270009,2022-10-31
eed9f87548397b1e,verizon ,378831133,25369650,476,3127,404204386,2022-10-31
3a6fd54aeba4c5d0,verizon ,13979888048,231792412,792848,87914,14212561222,2022-10-31
c024a7e06161b362,red pocket,899686200,36632798,840029,123962,937282989,2022-10-31
ee61aa215be23bbd,red pocket,144586,59517,83611,15017,302731,2022-10-31
65a35c9976159b14,,629718,183291,84,84,813177,2022-10-31
3e5ad467bb0dc1f3,,57189607,11826819,6719,2033,69025178,2022-10-31
b66ba6908952698d,mint,709336,204819,108576,55631,1078362,2022-10-31
5d7a640a11e62ccc,mint,785620,278732,20235,7024,1091611,2022-10-31
3fd7a82e7a936df5,mint,913509628,39403930,0,510,952914068,2022-10-31
47470f91f38bdecc,mint,594921933,13405287,95128,32232,608454580,2022-10-31
869c9532a7bc58e3,home,807275,295591,210557,47395,1360818,2022-10-31
2ced15adf0dff25e,at&t,833377,258021,38490886,921001,40503285,2022-10-31
6ce68a395c5fe7e0,,13036,3171,0,0,16207,2022-10-31
fa3798eb5b7668f6,t-mobile,1116663976,21798284,0,0,1138462260,2022-10-31
dea7cc2c8b0c2eb5,mint,26687,122340,233,208,149468,2022-10-31
910339f5e009332d,mint,2144144084,39511144,0,0,2183655228,2022-10-31
2f5679cedc65023b,t-mobile,793203,290211,489456,182536,1755406,2022-10-31
c62319959fd59d16,t-mobile,166589480,7062085,960991,180052,174792608,2022-10-31
5eab600b8762cfe0,verizon ,137554827,20959547,0,0,158514374,2022-10-31
aa9d241ccf64d014,mint,5198289597,123286595,539357,62809,5322178358,2022-10-31
4691082739929eaa,mint,151154741,3419640,23478,5336,154603195,2022-10-31
68f9e865036d5cf1,metro by t-mobile,228605119,3213282,43032595,1191448,276042444,2022-10-31
38f0385f3a59becb,mint,105296073,1949396,0,350,107245819,2022-10-31
bf97d9b9197ecee6,mint,1375011606,83991937,21698,6447,1459031688,2022-10-31
bffb74be8c7ce657,mint,1184004502,117744127,744198,104526,1302597353,2022-10-31
5027f8dba1b2c40c,,148853949,2631100,0,0,151485049,2022-10-31
73b2a78bd7230361,t-mobile,412386,17275,930563,209856,1570080,2022-10-31
aac20b9c55466f20,mint,81,728,498,1462,2769,2022-10-31
5e9041bbb96679c5,,886995,575632,804302,272072,2539001,2022-10-31
7e3fdec7f458487b,,131270,513209,0,0,644479,2022-10-31
373be505d3b14d5a,mint,1095091351,39065013,74077,23823,1134254264,2022-10-31
ba47f521b39287d2,mint,12270550,283289,994909,353827,13902575,2022-10-31
f54ccd04b317bf05,t-mobile,1240214089,83423139,3751,1206,1323642185,2022-10-31
1745cb80e123080c,pure talk,0,0,13433,4435,17868,2022-10-31
80d47667b2e545ff,,29176111,858882,16080098,1093059,47208150,2022-10-31
1f938ffb779deb1e,mint,312122308,35002903,58467,20907,347204585,2022-10-31
169d5cddf97a09be,t-mobile,722818520,16280374,23843,12341,739135078,2022-10-31
a1ea1214644e2c26,mint,320382589,25034624,1344534,99981,346861728,2022-10-31
5aa53da11b43ba94,mint,181116780,21481882,29253,27600,202655515,2022-10-31
7c644a83b1355b09,mint,866840,260918,379308,134624,1641690,2022-10-31
92c41e249e27b59a,verizon,1184112107,16021301,0,0,1200133408,2022-10-31
c466f8e07d3f06e1,t-mobile,113827227,10072521,0,0,123899748,2022-10-31
2539ae6cd913b152,t-mobile,276503950,3583341,141985907,5207055,427280253,2022-10-31
9200cc420c6ab0ef,mint,29808,8863,84,84,38839,2022-10-31
04a38511c44d73fa,t-mobile,0,0,90684813,2234217,92919030,2022-10-31
2e1071749b6d44d0,,2283733943,40569861,0,0,2324303804,2022-10-31
784af2a2041cfc98,mint,1524559746,37508675,20565,6826,1562095812,2022-10-31
43084942be6413aa,mint,888925,263933,0,0,1152858,2022-10-31
f4f6aa0902dd129a,mint,723637380,63344520,1869652,377977,789229529,2022-10-31
a812916b0f0585d7,home,1421898117,20282107,0,0,1442180224,2022-10-31
b1fc95276a9afa55,at&t,1833668364,21509242,749581,247012,1856174199,2022-10-31
08ac059957582d3c,mint,49861,124512,104,104,174581,2022-10-31
19d1f00940a34129,t-mobile,974171206,47176087,60967,26563,1021434823,2022-10-31
80c6ad43e12554ea,mint,740194316,27397733,0,0,767592049,2022-10-31
938d98910ab3a5b2,metro by t-mobile,832529097,77675601,979439,163313,911347450,2022-10-31
7640dede90ec93f1,,2299394,203186,0,0,2502580,2022-10-31
cd8949cfb3d59022,,34190250,685908,0,0,34876158,2022-10-31
7da966625fd2305d,,24493,6717,167165,66709,265084,2022-10-31
b64d54780f6aa9a1,,203013449,4027397,0,0,207040846,2022-10-31
1e180b69d7b2f76d,mint,1742898432,88086209,1823582,273611,1833081834,2022-10-31
7abac6e406a76e85,t-mobile,0,0,591396,39884,631280,2022-10-31
a42c347cb3657a1f,,149174378,3329386,0,0,152503764,2022-10-31
fbd30b7a64e242f2,t-mobile,177819553,4012268,214996,92988,182139805,2022-10-31
f0a74aa2da522096,t-mobile,688083,242023,209580,62838,1202524,2022-10-31
f2c04a31c1dab198,,1519603,282339,0,0,1801942,2022-10-31
873b88d44b95f167,mint,669731387,57069508,34967,2875,726838737,2022-10-31
15d29ac9e36ddc71,,118020451,2861852,0,0,120882303,2022-10-31
fe264794b28d17b9,,918683322,14613583,0,0,933296905,2022-10-31
b158c15d2ca4511f,mint,800081043,90660571,57972,19956,890819542,2022-10-31
d5272d141140e9e6,mint,26122,11663,0,0,37785,2022-10-31
4f290b1af7a3d58d,red pocket,238859831,17513498,0,60,256373389,2022-10-31
f4dd292c4508928c,mint,466396829,37117097,823700,108972,504446598,2022-10-31
8bb45c9c8ac1f924,mint,39720947,1363274,7848,2298,41094367,2022-10-31
05c1dea1119dd7ba,mint,149565,41098,16494,4283,211440,2022-10-31
8f806838bd6bec39,mint,771697,223217,136824,53422,1185160,2022-10-31
5e62ddd96c82c3d5,t-mobile,654376957,58355491,74606,24481,712831535,2022-10-31
0fa3c910234c5319,t-mobile,620338100,55490324,1094259,204747,677127430,2022-10-31
3564170d14ef47c6,mint,1855590412,36322707,22351,15348,1891950818,2022-10-31
9dced8ad07f84326,,316181623,25465840,0,0,341647463,2022-10-31
369d8213cd19769c,mint,569107501,48875741,36226,12905,618032373,2022-10-31
a280fa1c8ad4102e,t-mobile,494437,132255,121784,37485,785961,2022-10-31
b0bfef6520a9aa14,,48458908,7924327,0,0,56383235,2022-10-31
f98f7ab15d8bf3fc,mint,205883126,19580797,130527,46162,225640612,2022-10-31
b2466aaa1827c7b8,mint,245672508,4567419,39690965,846393,290777285,2022-10-31
7b6ecc42bfe0db79,mint,134324,33262,174257,53839,395682,2022-10-31
d6e9db6a84cc5c38,mint,28123,9231,683895,94101,815350,2022-10-31
44761a1c3eca1197,mint,1482079904,17700454,17878,5262,1499803498,2022-10-31
cd9e263bed2ed427,t-mobile,386203533,20439041,6672,1948,406651194,2022-10-31
bfbf28d30ce3cce8,mint,1003632,221916,20579879,986259,22791686,2022-10-31
34aa60fb396833bb,t-mobile,140741880,3025294,9137,2352,143778663,2022-10-31
ef746b62545fc396,t-mobile,795012713,55612590,12224,2507,850640034,2022-10-31
a111e6e163fa691a,mint,0,0,30993,10728,41721,2022-10-31
b6558e1d2a14235e,,812914,294530,12404,120919,1240767,2022-10-31
b7bcb0ef15b400a9,mint,229510833,4206099,0,0,233716932,2022-10-31
1ed1c63ca073cdfa,t-mobile,440641274,63116935,516129,54126,504328464,2022-10-31
667578b3436f91a0,at&t,794402,252442,18086,8022,1072952,2022-10-31
969aba4bba340b43,mint,1416320553,86728510,66,233,1503049362,2022-10-31
e4878dd9e78a56dc,,1197403684,74386217,0,0,1271789901,2022-10-31
557e24ea8d05b97b,verizon ,3331358638,102507861,711558,68481,3434646538,2022-10-31
f22557acbbb6a9d6,mint,4813759,1095389,74369,36888,6020405,2022-10-31
9c95240a32ecf80c,mint,836612276,63842320,990373,184722,901629691,2022-10-31
cf19d161fccfefec,mint,118487064,5217793,18792,9971,123733620,2022-10-31
372f8298dba80492,mint,606796050,55219777,29223,9335,662054385,2022-10-31
295c92dfd17ce920,,113886,28785,0,0,142671,2022-10-31
98f41710398f878f,verizon ,470069895,54321827,857765,103688,525353175,2022-10-31
b18b355eccce75ad,verizon ,1128285097,76700333,623087,19216,1205627733,2022-10-31
3cd1e8136bfe2939,t-mobile,914903764,43852037,780332,77020,959613153,2022-10-31
823588174c6bba8a,t-mobile,1678067988,40613187,1381047,344825,1720407047,2022-10-31
47ac6b5a69b675cf,verizon ,907424587,69365744,6574,1741,976798646,2022-10-31
5e43ac3cf8583bf4,verizon ,635021002,60675212,20635,6337,695723186,2022-10-31
d1b9758f554d096a,verizon ,1952458585,28806210,151858,44830,1981461483,2022-10-31
5f0dad7bc92f9dfb,mint,1514966447,35467210,1317904,61030,1551812591,2022-10-31
29f6ee39d03ca661,,61727095,817071,0,0,62544166,2022-12-31
e106fccc5e1616f9,mint,751047283,45328460,1671259,111020,798158022,2022-12-31
a6cf12b3d0d5ebf3,,1153545222,82302199,785094,115627,1236748142,2022-12-31
8d587cca29da2021,at&t,1029522708,73854786,1455291,245603,1105078388,2022-12-31
e03dcb9208344d18,verizon ,1796759283,88567744,1066993,131052,1886525072,2022-12-31
63f0f02add233130,mint,2027569627,110449084,109100,33961,2138161772,2022-12-31
2aecdd862145ee20,,500044662,44070336,48625,17007,544180630,2022-12-31
996d8074c189c042,at&t,953064488,74848095,592488,62943,1028568014,2022-12-31
692c091742a0af66,verizon ,3146679708,87258339,708982,7931,3234654960,2022-12-31
e0de815c6079a25a,at&t,2088392279,89856670,27864,8587,2178285400,2022-12-31
919adfa765989255,verizon wireless,424428939,99440609,697207,76439,524643194,2022-12-31
10596bb3b567474d,,293200856,8967527,0,0,302168383,2022-12-31
78e262f7f40ef250,t-mobile,0,0,1130206,355805,1486011,2022-12-31
af1dd780b583d2d9,verizon ,1301914041,80081484,2781483,456062,1385233070,2022-12-31
cada6d18a60944ea,verizon ,801432362,67995089,83849,44409,869555709,2022-12-31
6796212cef500980,at&t,664336609,65756847,725867,21427,730840750,2022-12-31
26d0cd824c452c5d,t-mobile,0,0,4176090,1057634,5233724,2022-12-31
bcddb7ff5b35d6a4,at&t,856746733,56618118,48305,13711,913426867,2022-12-31
9620a0d8e8c947d9,verizon ,551662560,44303229,2184883,304734,598455406,2022-12-31
96b1572362e2c5f5,mint,1039903362,61941140,708459,11277,1102564238,2022-12-31
8cd8b6142220261c,verizon ,746608124,64484047,1473052,63431,812628654,2022-12-31
3e6a1a9192593093,,897533,253169,0,0,1150702,2022-12-31
75defc125ceaeff3,verizon ,0,0,491548,1694840,2186388,2022-12-31
6bd2276f736923e1,verizon ,271361112,5636893,1485828,72328,278556161,2022-12-31
53ff327f414455ca,verizon ,814506,232452,7435,2953,1057346,2022-12-31
be626a4490e456e1,at&t,881993767,42985279,907750,108616,925995412,2022-12-31
105145799250119c,mint,133672039,25457332,104,104,159129579,2022-12-31
5a843ce095133c36,,31815,7046,0,0,38861,2022-12-31
78968fa3a506baf2,at&t,3716095262,69511119,2652613,576330,3788835324,2022-12-31
6617d75ed18a9721,verizon ,792360767,64263073,638610,64600,857327050,2022-12-31
1510ee0eec3e17ea,at&t,216479,83958,697272,236317,1234026,2022-12-31
e38be6833e10463d,mint,913929397,91182243,12803,3391,1005127834,2022-12-31
1711ad11f747a356,mint,53963755,1019954,0,0,54983709,2022-12-31
5e7270ce0cbbdaff,,162134740,3375748,0,0,165510488,2022-12-31
a55cba7359a0477d,at&t,1484412573,60517870,1469869,54112,1546454424,2022-12-31
62727afeca482dbb,mint,40046961,4200322,0,0,44247283,2022-12-31
c1940a8854d15a02,t-mobile,40767467,1381348,103016,130364,42382195,2022-12-31
2c241e8f1de98095,mint,146967665,2208654,38338555,663555,188178429,2022-12-31
07c61f3fd1926dfd,mint,904802442,26274397,0,0,931076839,2022-12-31
f75d4ae8db905347,mint,1092314904,78851435,0,0,1171166339,2022-12-31
9c6583d9e1d8d572,mint,219392305,4711647,0,0,224103952,2022-12-31
db7179c60ff67315,mint,619522617,8361095,1107116,355119,629345947,2022-12-31
e3044d1810fddb3e,mint,84,84,39878442,1169162,41047772,2022-12-31
04184f398eb702df,mint,0,0,774016,289531,1063547,2022-12-31
2595992e93cf2229,mint,159831,41587,0,0,201418,2022-12-31
35051745c55dadc9,mint,993324617,30256406,729778,61195,1024371996,2022-12-31
8f125f4e8c5c75ad,t-mobile,155083366,5587355,27404,114036,160812161,2022-12-31
906c93697eb0c588,altice meo,139391639,4313513,1498,24842,143731492,2022-12-31
0c213eef335ed5c3,,95945392,1661331,0,0,97606723,2022-12-31
d49a87966ba21d0f,mint,0,0,1007491,234982,1242473,2022-12-31
cb742728a8b5673c,at&t,551403480,48333587,19955,5681,599762703,2022-12-31
361f97dcb712d371,t-mobile,994013887,63315435,6621,1701,1057337644,2022-12-31
bfb40984f9fd59ec,movistar,49174821,7753341,0,0,56928162,2022-12-31
e5a2b67494ab2de4,at&t,873023013,70724814,56635,22420,943826882,2022-12-31
5c1822a5789eef35,verizon ,1620893380,64913564,1420037,17695,1687244676,2022-12-31
e2c24d137206201f,at&t,701182524,48891067,57298,21601,750152490,2022-12-31
5cd18a2651434e65,,227044510,1689555,0,0,228734065,2022-12-31
632d2de9fb829f6a,at&t,43466594,1070223,1033133,305550,45875500,2022-12-31
445b948c005d3908,pure talk,262334280,27276592,1479180,57305,291147357,2022-12-31
a05cfacc61430ef3,at&t,1174419377,91553974,1468769,50390,1267492510,2022-12-31
638a859d8c8571c1,verizon ,4393281107,118738704,1516028,94617,4513630456,2022-12-31
436325acb3af0a81,verizon ,1441924414,76886533,728918,18246,1519558111,2022-12-31
be3cafa00998ace7,,1586378124,73316459,137582,66031,1659898196,2022-12-31
b3c507a94cdbc9a1,mint,2148935565,95274439,50424,20194,2244280622,2022-12-31
e3a40ff0976fa25b,cricket,2565556674,25491894,13901,4006,2591066475,2022-12-31
99c3a3a95c763535,Â ,1820287854,91935396,100308,35835,1912359393,2022-12-31
d9cd9be3be98397f,mint,1220448693,85586930,721960,18315,1306775898,2022-12-31
7df408e319eaeb11,at&t,549406013,54221732,743043,41815,604412603,2022-12-31
01b9feb95e786669,at&t,0,0,1490009,117622,1607631,2022-12-31
4256357247d5a5e9,verizon ,827926918,51026399,95628,29818,879078763,2022-12-31
9df48ff3b5c5c6c2,t-mobile,2265521955,123842977,0,0,2389364932,2022-12-31
5a99f69378bff167,at&t,325993895,19811626,796787,123736,346726044,2022-12-31
c42ebf364150f194,,190542428,13139620,0,0,203682048,2022-12-31
3c7634e2e443cb9a,verizon ,866880451,36243611,1456818,67987,904648867,2022-12-31
3ef3a3b5bc464047,at&t,0,0,24717,10251,34968,2022-12-31
fe711f2200d8d984,mint,943285809,91879428,707517,15788,1035888542,2022-12-31
29e2e8e67fbeb596,mint,406089205,27004487,1479231,47259,434620182,2022-12-31
e88883ca79d1d00b,verizon ,688975767,73389459,13440,3748,762382414,2022-12-31
3adc97d3872c52c0,,5773245097,93393343,0,4784,5866643224,2022-12-31
73d43b32b682bc9f,mint,736879588,55839808,35389,10935,792765720,2022-12-31
f8c3b82a421438a0,t-mobile,901245598,74874100,905130,74384,977099212,2022-12-31
7ffebb7f98802e82,,114482350,1699040,1073017,302620,117557027,2022-12-31
4982b60bfb396f80,mint,1081585318,55169677,1454190,52402,1138261587,2022-12-31
1c87f949c5d860d3,mint,250672744,34498916,770469,44473,285986602,2022-12-31
ee92805c769373e7,,1357174,227096,134397,44592,1763259,2022-12-31
be9c91cb522da477,,202515322,3522206,0,0,206037528,2022-12-31
ef375cfcae865bda,,581066101,19434518,49627,30984,600581230,2022-12-31
0842d2a1f5433a13,mint,650747033,55726518,1556439,210101,708240091,2022-12-31
00d77acbcebf47e6,metro by t-mobile,1027203715,80122088,2175160,127604,1109628567,2022-12-31
8be47b7290a02273,us mobile,119383312,6869551,538049,42436,126833348,2022-12-31
376e0411d9d18744,t-mobile,857184785,42162722,570885,44680,899963072,2022-12-31
932657a13b3f391c,t-mobile,858322,273967,6532,291360,1430181,2022-12-31
6eed5be138c315a5,mint,1361549,231628,0,510,1593687,2022-12-31
cb9294cdfcb04868,metro by t-mobile,1170079523,53957376,0,0,1224036899,2022-12-31
c89d54d72c146b0a,mint,945402986,51256312,34377,9025,996702700,2022-12-31
0f118e260c79466b,mint,328997569,24260450,1436,16670,353276125,2022-12-31
b653f934e537dc0c,,36535027,538209,0,0,37073236,2022-12-31
55b9f5e3f16fd60f,,3693399112,74865157,16254164,1099692,3785618125,2022-12-31
e05f21eacb5d6f1a,t-mobile,825670150,50822713,125877,37469,876656209,2022-12-31
ccf7309acd92a2a1,mint,142377,39334,0,0,181711,2022-12-31
d097109696440d9a,mint,631890207,59875219,142628,67004,691975058,2022-10-31
130749dacb1679d4,,74504315,1611986,0,0,76116301,2022-10-31
4236af4f28a408bd,mint,2666372,1347188,7604,1948,4023112,2022-10-31
dd3941386a2211ca,mint,315972032,8954284,0,0,324926316,2022-10-31
07c5a37d3a7fbdb6,,679913162,8652195,0,0,688565357,2022-10-31
4cd9496c79385127,t-mobile,1212026800,19963331,671997,37392,1232699520,2022-10-31
cbff0c1387983db7,metro by t-mobile,430507986,21581465,7760,3363,452100574,2022-10-31
3868be7bae5743d2,t-mobile,8602,2522,7820,5190,24134,2022-10-31
394b3369029c7328,mint,3312918198,70655246,0,0,3383573444,2022-10-31
4b404b206d36f419,mint,455326959,29016357,0,0,484343316,2022-10-31
82aba5a8b2a340c2,,307886950,15092153,0,0,322979103,2022-10-31
8055c99589107bca,mint,870841583,33730394,0,0,904571977,2022-10-31
cbd3c95b914edbb6,,86584980,3004449,0,0,89589429,2022-10-31
096fc04fe8a9bd75,t-mobile,128554401,7088552,29100,10465,135682518,2022-10-31
13798d3dabedb094,,639790207,8335945,1464,15292,648142908,2022-10-31
3be1db7c81fac5a0,,143693857,4511485,0,0,148205342,2022-10-31
41f92122fe7e80e7,,275838260,16472441,0,0,292310701,2022-10-31
efa38fee80ed94a9,,167274,87683,408736,159735,823428,2022-10-31
664ed7e977458f4d,,1081460691,56869018,164962,70550,1138565221,2022-10-31
cca29f3e8ef9999f,verizon ,499187704,30033654,2200,664,529224222,2022-10-31
63a65ec07bbfe143,at&t,762048751,74848499,33435,32681,836963366,2022-10-31
4a70cfe39b57135b,at&t,155128933,1896677,9189,5897,157040696,2022-10-31
8f08ad886180d23f,at&t,1057297403,72629833,6534,1649,1129935419,2022-10-31
75d5f3ec17c77313,verizon ,3129925209,93624811,295963,104120,3223950103,2022-10-31
e89f4782a2a05594,verizon ,1122790968,54481862,21808,7176,1177301814,2022-10-31
4c7987163362a80e,mint,509523445,57389135,1016993,137155,568066728,2022-10-31
daffeeeb59dacd06,verizon ,1593692794,47883426,139544,49679,1641765443,2022-10-31
d153bb2651b280e6,verizon ,3113635102,109486841,1598995,165628,3224886566,2022-10-31
95141d4e3b1349e0,,617615732,13895906,20578,5796,631538012,2022-10-31
5f5e3350dadd4810,verizon ,39431459,495726,1610527,311076,41848788,2022-10-31
ddf7234c379b7136,mint,572715841,59194337,14437,4160,631928775,2022-10-31
500ae2117d1b49ae,mint,540148820,27686366,84,84,567835354,2022-10-31
fa12246cf709a774,t-mobile,816863573,46213091,1048173,168634,864293471,2022-10-31
74ed3114b07ea34f,verizon ,758881296,76471897,6416,1688,835361297,2022-10-31
ebeb241f0bf7d0e2,verizon ,660881,184053,235893,73949,1154776,2022-10-31
9e88742d45165688,verizon ,226611771,23462515,1068558,168549,251311393,2022-10-31
71a9ecec5df1b5c9,,195334352,32957221,84,84,228291741,2022-10-31
9284291985067d2e,,148300448,2452323,0,0,150752771,2022-10-31
feace13bd6ebffe6,,615035558,35852571,0,0,650888129,2022-10-31
ae0af7e8854ba2cf,,719770683,110150446,22111,6093,829949333,2022-10-31
395471e90e4c224a,,147048656,3393582,0,0,150442238,2022-10-31
e860d4772d78c3d6,verizon ,402172863,9369118,0,0,411541981,2022-10-31
d84dfc607f46d1e9,verizon ,929163174,99519392,763205,72718,1029518489,2022-10-31
0af380ffa5830ddf,verizon ,673029233,41505718,1649701,226166,716410818,2022-10-31
9b29ccabaf8a213c,t-mobile,414564415,53187686,1181843,81426,469015370,2022-10-31
1c7672fb07ac4359,mint,890642416,36068891,36883,15981,926764171,2022-10-31
0cb474c4431f5bef,verizon ,820710896,75611822,1973053,253735,898549506,2022-10-31
a3a86fc6d946c129,at&t,786664181,67312290,752834,52961,854782266,2022-10-31
1a9c40efa1ca82f7,t-mobile,546698214,48441346,963511,154799,596257870,2022-10-31
0d9904ac920cc14b,mint,671748795,62470418,129876,17073,734366162,2022-10-31
bc33817b91b6f463,mint,444751224,67747970,6557,1951,512507702,2022-10-31
2816d29a3a99fd41,mint,282282905,37712310,2140,29731,320027086,2022-10-31
aa143f4db74fc3d2,verizon ,0,0,33716,6879,40595,2022-10-31
6adaf1520702c0a3,spectrum,1520208297,66711745,0,0,1586920042,2022-10-31
5474811fb3ce572f,mint,920277965,20306270,269980,111268,940965483,2022-10-31
30e1071630b4ae3f,mint,289221396,19961589,22241,6068,309211294,2022-10-31
1a5e34779bb3249e,mint,567122184,24953475,1012981,157898,593246538,2022-10-31
9da949b44af35ecd,mint,830967,253203,914899,808954,2808023,2022-10-31
87aef319535bb2bc,mint,1191945838,22718996,14992,107993,1214787819,2022-10-31
ab31e9382b88dd0a,t-mobile,887206,271127,15332,7159,1180824,2022-10-31
b457c5af74c87272,,147045343,2381639,0,0,149426982,2022-10-31
6186ac70195a934d,mint,722164769,39475612,430152,89462,762159995,2022-10-31
3a9d41f0d1da4185,mint,25624,3684,7490,2189,38987,2022-10-31
416c38ae63f2f44c,at&t,38785532,1352976,0,0,40138508,2022-10-31
854eb4f339c11bd4,,577721095,18274663,0,0,595995758,2022-10-31
7726e566a1a93954,mint,451235089,49443684,805,7084,500686662,2022-10-31
d4856b3862fdfa55,mint,470624219,27099028,57440,19742,497800429,2022-10-31
cabdec1c7882d6e4,,146748014,2163792,0,0,148911806,2022-10-31
bc07b4c5c947e88d,verizon ,362033624,24320193,1365447,78611,387797875,2022-10-31
8ec5c46f145a67df,at&t,606219,174894,40569,10348,832030,2022-10-31
c8ec97a706ebdb1c,verizon ,735148356,68599977,13183,3222,803764738,2022-10-31
493e517787959498,at&t,871866623,46844647,525,849,918712644,2022-10-31
71154fb489834448,at&t,686874138,61138294,669200,37843,748719475,2022-10-31
288b6e6648bd1183,at&t,1074457410,36272223,1314525,169361,1112213519,2022-10-31
ab7359a7f12f0ec1,at&t,624846136,61692329,13259,3298,686555022,2022-10-31
e3b8d646c28aa4b2,verizon ,540380041,68459040,6661,1689,608847431,2022-10-31
fec8819d776d47ae,verizon ,1737466,2082604,146017220,2247690,152084980,2022-10-31
0ad8a0cfdbb8d183,at&t,317204963,31979376,1011456,182713,350378508,2022-10-31
86d6d712626b59ae,mint,3349052365,62133631,1149205,224512,3412559713,2022-10-31
d4234254a0d7e259,verizon ,496845378,67174012,32245,15687,564067322,2022-10-31
b0c5e265e5ffcc1e,mint,777683597,62343661,84,84,840027426,2022-10-31
973ea2f5149898a4,verizon ,930763082,87975272,84,84,1018738522,2022-10-31
ca136e1cc2520fbd,at&t,362637423,41994382,710270,117259,405459334,2022-10-31
cf9c0bf6cca23e1d,verizon ,1220725933,108397337,84120,25342,1329232732,2022-10-31
615434862235a19b,t-mobile,1089398309,94721298,151399,56733,1184327739,2022-10-31
ae41fd956879dcfc,,703936050,82225694,0,0,786161744,2022-10-31
c4097f9f9722dae6,,191302,64950,0,0,256252,2022-10-31
ce3b45e9e3870bab,mint,804509335,104653521,177381,65268,909405505,2022-10-31
acd1756a607da8cc,mint,1086475125,59017644,872009,104948,1146469726,2022-10-31
c3c2950e36284292,at&t,723018851,74287741,867419,126262,798300273,2022-10-31
bc04eda4157e1e77,t-mobile,182120283,14105018,675991,46330,196947622,2022-10-31
371c780385760969,mint,2404853222,100155535,34428267,686986,2540124010,2022-10-31
266940d8c027bd55,verizon ,422788362,54850905,246327,87981,477973575,2022-10-31
fbf67ad18a5dabdb,verizon ,381607991,3888304,297239,127950,385921484,2022-10-31
3bb610a9a59e0e80,verizon ,808701594,79808387,699008,76984,889285973,2022-10-31
817c21bb85aa5c38,at&t,672966,247143,7535,1688,929332,2022-10-31
7f6678342262e49e,verizon ,804859,236392,0,0,1041251,2022-10-31
0d69297362fd3351,mint,850819117,79117944,213001,78276,930228338,2022-10-31
48bd7c81cc89caca,,497134435,78862074,314177,90588,576401274,2022-10-31
de641b34f8a8fe96,mint,336904717,37596547,43021,14278,374558563,2022-10-31
e41db089afcceaae,mint,759710954,56494279,0,0,816205233,2022-10-31
cd510c98d2cbb0bb,mint,5265642111,103741557,1342793,78262,5370804723,2022-10-31
0d28a0420df1faad,,166194078,3020701,0,0,169214779,2022-10-31
0b4ad073e1a00aef,,173747940,3643264,0,0,177391204,2022-10-31
6169ceb254881dd2,t-mobile,6816181,1237653,1235298,230116,9519248,2022-10-31
6cc423e0a0faab77,t-mobile,5273788726,121616187,990414,147572,5396542899,2022-10-31
77dae21d42f6f6e1,mint,181289533,3594311,34752,17910,184936506,2022-10-31
de9daa491876a456,mint,194452684,11792815,0,0,206245499,2022-10-31
7c6c42fad841ee82,metro by t-mobile,534127863,22009044,110760,40796,556288463,2022-10-31
64be8d62483ca4b0,t-mobile,346644073,46825838,1278614,69172,394817697,2022-10-31
2526f78b95392313,mint,874816738,67740215,1133994,229522,943920469,2022-10-31
5435d06c25c7b40f,t-mobile,1055052295,57754240,147720,40538,1112994793,2022-10-31
0133a304f61ed623,mint,324656752,21166611,21203630,1305753,368332746,2022-10-31
54fba81ff6cca324,mint,3353991,300560,0,170,3654721,2022-10-31
6d3aec08417993ef,,640195048,8837088,0,0,649032136,2022-10-31
f62c9f4a66a3bc62,t-mobile,142137295,9870782,1694862,222820,153925759,2022-10-31
8affeeb4f54619c7,t-mobile,1157085,244728,847664,180950,2430427,2022-10-31
8170bc110e6e62fd,mint,650160479,50500248,876746,120496,701657969,2022-10-31
9cce371f04b9e358,mint,122950131,4697668,0,0,127647799,2022-10-31
adcc386f59cf482e,mint,279141259,20505430,117965,27102,299791756,2022-10-31
1afd92e684e96b3b,,951613228,9396480,0,0,961009708,2022-10-31
3ac1983ca794b1f5,mint,385536724,15648493,17160,6275,401208652,2022-10-31
6e8737f932778c8e,t-mobile,25867,7113,39885599,2132673,42051252,2022-10-31
b3a26ba2517e41b9,mint,962823534,47611384,62986,23669,1010521573,2022-10-31
adea3c40dec748f8,mint,340772932,29507556,24765,11310,370316563,2022-10-31
b0871f9e9fec2b19,metro by t-mobile,1257849188,41144736,1891919,366207,1301252050,2022-10-31
8f9a72fb7ca4e902,mint,650993483,72159795,1338519,292167,724783964,2022-10-31
2210e854b6db3e68,mint,212423727,41324979,1896029,376308,256021043,2022-10-31
faea5c4c26c71522,,7852986442,162067464,625826,46348,8015726080,2022-10-31
9725184650d540d4,,154300266,2184788,0,0,156485054,2022-10-31
01da4691a07528f1,t-mobile,198435515,21662418,658,2112,220100703,2022-10-31
55dcd5afbf1c96f3,mint,46363,140344,7159,1678,195544,2022-10-31
a949fdf15b0910cb,t-mobile,258251561,8515614,54971430,1709093,323447698,2022-10-31
6cea7fb4c6e8bccc,mint,3511806889,61837739,104,104,3573644836,2022-10-31
d0fb270a639fb951,mint,180320,529197,945940,68101,1723558,2022-10-31
a9507ba60f42b91d,,522936748,52328174,269378,103482,575637782,2022-10-31
ce6c02cac3b088a9,mint,1953347288,52606203,8281,2117,2005963889,2022-10-31
07d379f8f19df734,mint,142963143,17865171,1714678,243385,162786377,2022-10-31
652c2b82ce9c87b4,mint,2942103430,89318374,651807,38335,3032111946,2022-10-31
3e531c2b030588cb,mint,328337162,5305374,13477,4426,333660439,2022-10-31
f5fe338d7d70db65,mint,118481666,18867218,58803,28985,137436672,2022-10-31
99728348ec71947c,mint,685556293,63510077,1380451,191629,750638450,2022-10-31
dc4bd700b84d3342,mint,264003761,3469198,0,0,267472959,2022-10-31
52d5fd6d486f65fe,mint,123949557,2111827,0,0,126061384,2022-10-31
025d1660ae56eb29,mint,890434,253070,211394,53271,1408169,2022-10-31
0c4fc31d1f74d731,,195124529,3674632,0,0,198799161,2022-10-31
42e18b246f11f310,at&t,1046392412,71928763,754886,56619,1119132680,2022-10-31
e28865200a1f98f5,at&t,2683134974,69778864,6899,1912,2752922649,2022-10-31
bc11c843c36a7885,,398767398,9148534,1856480,576196,410348608,2022-10-31
0e37abb3714c9e39,t-mobile,4809810483,114171402,171327,58061,4924211273,2022-10-31
06eb4b4992a1d0d5,mint,1012163439,103500288,6621,1701,1115672049,2022-10-31
2b6d699d8c3cf556,verizon ,1040013467,66711190,1041709,167153,1107933519,2022-10-31
a2d623b9362031f8,verizon ,875641194,57525634,54967,15995,933237790,2022-10-31
f79ee80462977d6f,,860251742,62229755,738094,93994,923313585,2022-10-31
90a15107cea53a33,t-mobile,832432342,70275221,6100,802,902714465,2022-10-31
2d5d85de364a7a57,verizon ,608474,155948,390134,305271,1459827,2022-10-31
9383a2014bc16393,verizon ,158948395,24826447,2187745,779795,186742382,2022-10-31
826c0d197097ee5e,at&t,968996996,70355562,3864420,1380871,1044597849,2022-10-31
8b3f5146e778646b,at&t,913517367,65518603,1080989,188196,980305155,2022-10-31
32435c5ab3d8db01,verizon ,243418041,12741093,1695055,273520,258127709,2022-10-31
7a1eb3397c5e18c4,at&t,3653394968,90108892,1315003,137030,3744955893,2022-10-31
89a8244077394060,,1214760396,22153305,0,0,1236913701,2022-10-31
27b1a18231630ba9,verizon ,603209426,58840961,25324,13615,662089326,2022-10-31
afb6b4bdfceb6ce6,verizon wireless,743498226,64638347,158898,54788,808350259,2022-10-31
8600dd46dc155ff1,telus,56297590,8634949,0,0,64932539,2022-10-31
0180f35b3a004e3a,verizon ,880088569,87411953,6300,1353,967508175,2022-10-31
6b4126bb10be0de9,verizon ,85373366,3275727,794617,116622,89560332,2022-10-31
e2f0494a0a5716f6,mint,711068836,48309334,1269775,507485,761155430,2022-10-31
e14d69d8fbe751b9,at&t,571368646,64823206,13622,4166,636209640,2022-10-31
a08bef4af48a45ee,,160181141,19350363,69444,26886,179627834,2022-10-31
80681a8b78b72934,at&t,627249489,70069594,1264808,155421,698739312,2022-10-31
82e4e84d323171f2,verizon wireless,1235273531,64819485,84,84,1300093184,2022-10-31
6c3caa07ea75f610,t-mobile,969768541,63745818,92313,31686,1033638358,2022-10-31
9877767053a7e0b3,mint,542492438,68823676,1291371,45384,612652869,2022-10-31
51428f76bf96e9e4,verizon ,19571283812,240062188,340369,138347,19811824716,2022-10-31
dd0f551df5462a9c,verizon ,5592662494,114320827,31538,14877,5707029736,2022-10-31
6410b1146466924c,t-mobile,2535777522,74511557,57177,19933,2610366189,2022-10-31
4aac697247ed4efd,mint,1113291739,75946164,89705,42828,1189370436,2022-10-31
948e92d1ccc8def3,verizon ,998034106,81769380,416,170,1079804072,2022-10-31
12426e617c45459d,,128867875,3283671,0,0,132151546,2022-10-31
2974fbf4b896387f,mint,733542,137081,54820029,1860070,57550722,2022-10-31
4d70cd1ec30bba1f,,141820824,3144938,0,0,144965762,2022-10-31
52c5af63383422ec,t-mobile,849608594,61604999,171170,61683,911446446,2022-10-31
54edd2c353601168,mint,152130948,15278080,1106725,236598,168752351,2022-10-31
92a8a1bfcad91aec,mint,913840590,72154547,7128,2481,986004746,2022-10-31
591ea241a0984cd6,t-mobile,350000863,30076511,986,316,380078676,2022-10-31
cc2512051f258956,,123822867,4084675,1074031,445576,129427149,2022-10-31
3d29ecba6c4da65b,t-mobile,179139352,3101871,27158,16030,182284411,2022-10-31
b1562554e4b650e3,t-mobile,672551647,45985603,22826,8006,718568082,2022-10-31
1bec375451a17344,,270072095,5428799,0,0,275500894,2022-10-31
a638c57ab3bad64b,mint,100194521,11388583,1278883,272994,113134981,2022-10-31
9322f2d33cf61105,mint,128607992,2631685,24059,237489,131501225,2022-10-31
a70c07047b536eec,t-mobile,319373459,12763672,0,0,332137131,2022-10-31
59498f5efd7663ea,mint,400999622,9249680,0,0,410249302,2022-10-31
1b2b5ac1e5ee0c8c,mint,459842262,39673656,33326,7983,499557227,2022-10-31
9adaac967af29fa5,t-mobile,510457,148242,6067,1391,666157,2022-10-31
1d24005e3daed661,t-mobile,791986048,71642665,7170,2859,863638742,2022-10-31
cbbd57848c45ddc7,,44863220,1728037,0,0,46591257,2022-10-31
8d84d76e151434e8,,134220959,4124020,0,0,138344979,2022-10-31
4a6d6cf6ef424edb,t-mobile,965133827,58592670,13814,2350,1023742661,2022-10-31
465d3f2fd64d0691,t-mobile,1311456507,45976950,210334,81041,1357724832,2022-12-31
48463c3479d1f6a8,mint,601425374,31306257,0,0,632731631,2022-12-31
939c68d8ab2a59f3,at&t,126872802,13196904,473772,40741,140584219,2022-12-31
cd7492953fe7d541,mint,777424004,14063845,350522,80669,791919040,2022-12-31
2e026c6f0084e1cb,,2140212465,32380216,6672,1948,2172601301,2022-12-31
9692535435b89954,t-mobile,729835145,20330372,156348,66775,750388640,2022-12-31
ce0de88dea9a9afd,t-mobile,200305875,8432846,0,0,208738721,2022-12-31
52eb9be69c9f8339,,598874724,63449456,6935,2212,662333327,2022-12-31
7b8ccef1d7a43880,mint,494409673,19482433,0,0,513892106,2022-12-31
bf126214d5b2e20d,,698734,194340,7551,1688,902313,2022-12-31
d6adf581e377b884,mint,796603,233487,581056,185468,1796614,2022-12-31
9890c46069c118e0,t-mobile,228335511,3322831,1519645,213085,233391072,2022-12-31
58a55f8cd83c771b,mint,929355149,47608719,259728,99174,977322770,2022-12-31
541b746644db2f52,,285953105,6001683,0,0,291954788,2022-12-31
c5e5bf2647fee831,mint,35288,7198,0,0,42486,2022-12-31
1b89bbc85421d2d3,mint,1029734052,22794765,0,170,1052528987,2022-12-31
663dd69a55a32425,mint,19376978147,319775625,48721,24041,19696826534,2022-12-31
4deb220c8660146b,,764909154,49212795,14324,2435,814138708,2022-12-31
d82932273483da8d,,237645463,9768446,0,0,247413909,2022-12-31
e691bed24a201121,t-mobile,148457242,2647002,653388,187769,151945401,2022-12-31
61ec95ff4d9f405e,mint,8627406234,177302626,38733,17503,8804765096,2022-12-31
12e8e309df336670,mint,258024577,27481164,0,0,285505741,2022-12-31
4420172a1ea8a6d0,t-mobile,1492251604,50415253,0,0,1542666857,2022-12-31
c6d9530842bde804,mint,719761655,68266541,609239,78228,788715663,2022-12-31
37a76b25cc3313b6,mint,399938114,5713756,13354,2030,405667254,2022-12-31
da36d3c304a04158,,1170807881,61512966,0,1019,1232321866,2022-12-31
a300bf0e160e60fb,mint,172978906,6323434,13165,3824,179319329,2022-12-31
c30335830c567630,,152043679,9872744,553664,25491,162495578,2022-12-31
eb5ad2084393018e,verizon ,2105596271,91049762,1456160,42775,2198144968,2022-12-31
c136a3dfd848cef7,,21374,7691,0,0,29065,2022-12-31
a9d460e769d6210c,,424408,2324936,0,0,2749344,2022-12-31
c39ba1e9d8d16221,at&t,0,0,1405068,121594,1526662,2022-12-31
6509951398652444,at&t,491517216,34841536,1474472,106580,527939804,2022-12-31
208f6be3cc86402d,verizon ,1321024706,85874442,2158126,51189,1409108463,2022-12-31
1eb2c0087aef933b,at&t,217849,88224,951940,289221,1547234,2022-12-31
6104c332093a8683,verizon ,467758692,28240469,1447506,460148,497906815,2022-12-31
291978e194c2a478,verizon ,739698900,45159370,2180836,249473,787288579,2022-12-31
0d08862f83bdc491,,11025153,1857026,41932,12403,12936514,2022-12-31
7b3e90af63bb356a,at&t,362210563,25800268,1496048,82946,389589825,2022-12-31
d0e5c457c345451e,at&t,1032908902,73953609,28254,8690,1106899455,2022-12-31
6f9a74360f10827f,at&t,822654395,68813563,1448502,39614,892956074,2022-12-31
98bea89bff232bf8,verizon ,780077564,65922280,69059,23622,846092525,2022-12-31
ca5ab7e6f68ef591,verizon ,829079326,67653859,1424985,50022,898208192,2022-12-31
9903b2cb9a1f415a,mint,420064090,59735843,2614775,545563,482960271,2022-12-31
37ad19f0ee5d0291,verizon ,656690641,71624332,765756,52456,729133185,2022-12-31
6e8aa36d5013e17f,verizon ,994811413,45340210,215663,8937,1040376223,2022-12-31
9f5fe6ec66ce72b0,,150441687,2261890,0,0,152703577,2022-12-31
0e38b9bc12903bfd,verizon ,897316770,75688196,1444830,49136,974498932,2022-12-31
2a2872e08e26823c,mint,617102241,61491286,36389,15862,678645778,2022-12-31
97bd95cc08d4005d,t-mobile,1663640324,56916715,727386,11918,1721296343,2022-12-31
53c59f43f6312eea,at&t,110279945,7366469,1508818,110374,119265606,2022-12-31
343369a23ed9fdcd,verizon ,917671099,85682286,981273,125555,1004460213,2022-12-31
49aeb979f8808160,,915816131,54592853,1859097,450992,972719073,2022-12-31
b4f919fc9275a71c,at&t,593770075,46810771,1786081,205203,642572130,2022-12-31
f95806a025c5ce9c,t-mobile,849899745,53921568,35486,16794,903873593,2022-12-31
8ddf537f28335924,xfinity mobile,1310839387,61443901,2238525,345894,1374867707,2022-12-31
95e7b4b6e41c163a,mint,140911007,2364914,3490,1050,143280461,2022-12-31
cae68ae429fc4f23,telcel,498148294,28407214,709319,21529,527286356,2022-12-31
6e298980cc664f5b,mint,1780732828,78499573,722775,24344,1859979520,2022-12-31
a374bddba4e37267,mint,965090286,64510415,0,130,1029600831,2022-12-31
af31c20268a5f3a8,verizon ,401208069,27099116,977888,105953,429391026,2022-12-31
ec50130af43d4671,t-mobile,0,0,1002023,294716,1296739,2022-12-31
cd9c41a951fbb0dd,t-mobile,355969209,13000179,0,0,368969388,2022-12-31
6cbdf0a104685d4a,,550977796,61351653,844764,98616,613272829,2022-12-31
c6f47f34ef08f371,t-mobile,338331124,34101220,0,0,372432344,2022-12-31
f89962ee3179b411,mint,398650184,13704489,13904,4035,412372612,2022-12-31
b93653f2d999afed,,2512676,448264,0,0,2960940,2022-12-31
e332da1260360836,mint,415902953,31514892,14085,4286,447436216,2022-12-31
11f520c4bb0e975c,mint,851933101,50732484,90025,240856,902996466,2022-12-31
b5ca9f38fd24d022,t-mobile,1540176060,93972561,13428,4093,1634166142,2022-12-31
af99a1979077acbc,mint,952653932,85146739,28484,9372,1037838527,2022-12-31
bd9f50ef9b6e43f3,mint,344351566,27270286,578138,55881,372255871,2022-12-31
d4675eb6d9563442,,263722630,3039003,0,0,266761633,2022-12-31
6a78eab75fc69de2,t-mobile,957874,213031,254717,95570,1521192,2022-12-31
8788b32ec99f5b58,t-mobile,0,0,43814,13302,57116,2022-12-31
02caa462b14d3e4f,t-mobile,1592600021,104398905,26858,7783,1697033567,2022-12-31
d8a2ba7475fd8698,,118706415,2623550,0,0,121329965,2022-12-31
5856ec48d3acfd4f,mint,762371304,41650936,1499071,284337,805805648,2022-12-31
8d0684dd18061970,,56776,16894,0,0,73670,2022-12-31
c967b27cad9acce6,,223545232,4409538,0,0,227954770,2022-12-31
9c811b290c8a45f8,,192037735,3920795,0,0,195958530,2022-12-31
df11dce03d272d67,mint,671121096,39833093,718090,20215,711692494,2022-12-31
6edd7e3c2be4aaec,mint,149031574,2419105,40073254,1402734,192926667,2022-12-31
5570e0ed36c47fc0,mint,1057267227,62479962,28479,13468,1119789136,2022-12-31
bd32ca71125a9bde,cc network,0,0,709405,83841,793246,2022-12-31
ca83106da616bc2e,mint,814348572,60311611,713856,14684,875388723,2022-12-31
d5a9662354099805,mint,924842409,48765945,1452315,47184,975107853,2022-12-31
3ff301cf954b3832,,320115,1103528,0,0,1423643,2022-12-31
e85a185c620743ef,,48086580,9369200,0,0,57455780,2022-12-31
78d33c0fefa44b2d,at&t,861116421,57871868,1477159,96703,920562151,2022-12-31
4aa8b7fa97dc87b8,at&t,1227367285,76679855,63186,23107,1304133433,2022-12-31
2a951786f4090dd4,verizon ,711620401,43373867,1211639,40998,756246905,2022-12-31
7226182d81b245cf,verizon ,0,0,912739,90320,1003059,2022-12-31
dbaa822dbd1cebb4,at&t,0,0,591389,50795,642184,2022-12-31
df8291816c905b69,verizon ,437410168,11016582,84238,28905,448539893,2022-12-31
a1d244ab72b7ffe0,verizon ,151423151,20499254,264261,86066,172272732,2022-12-31
9f71e46ef9fa3791,at&t,870637106,64450924,70698,24823,935183551,2022-12-31
85bf81284f9c91c8,verizon ,364395620,21739917,2242,846,386138625,2022-12-31
b47f7315a37a08b4,,314044773,5828549,0,0,319873322,2022-12-31
793e2e8c667d2ae5,mint,703921667,65055404,722580,40547,769740198,2022-12-31
2cfae47523de5f47,mint,577804500,83599891,2393010,492497,664289898,2022-10-31
33691b6e693ccc4b,at&t,81188844,1689330,2014893,377422,85270489,2022-10-31
c8ef39d42404515f,mint,135013952,643774,54472,21338,135733536,2022-10-31
e0c776f7a720a9a2,mint,685428396,46116956,6863,2203,731554418,2022-10-31
34703beb23893b3b,,133558358,1472558,0,0,135030916,2022-10-31
744054a4e630f446,t-mobile,848370243,62787561,0,0,911157804,2022-10-31
4fbdace61aa15858,verizon ,974601215,70017759,1198695,150095,1045967764,2022-10-31
edcd854924783a26,,46259046,813914,0,0,47072960,2022-10-31
e5ffac7a265db0d6,verizon ,179103934,24468760,6802,2004,203581500,2022-10-31
a444bea8a5b88c8c,mint,1698814173,77597501,6621,1753,1776420048,2022-10-31
5cb45ec8b1cfe99a,verizon ,1055607342,80467341,836263,282789,1137193735,2022-10-31
a480b4c096909d48,,34370786,1647078,0,0,36017864,2022-10-31
1a724f463d3e660c,at&t,3644775317,93143627,357147,133460,3738409551,2022-10-31
ebccd21c12bf0a0f,t-mobile,1306917094,73222619,808552,65683,1381013948,2022-10-31
ae5b802090aed971,at&t,409927246,27674339,6098,1761,437609444,2022-10-31
fe7eaa5bb36ff7a8,at&t,289239012,38789458,1299510,260451,329588431,2022-10-31
d12496f9afffb02f,,243537972,5974151,0,0,249512123,2022-10-31
5b71e5bbb4031b2e,mint,718011662,65256639,21586219,940957,805795477,2022-10-31
55e892537e98c630,t-mobile,3369338763,68455966,6565,1889,3437803183,2022-10-31
201aed3a2766dfa1,,5586729,437187,0,0,6023916,2022-10-31
dd6301b4a53b7e71,mint,619788391,51027413,145183,59454,671020441,2022-10-31
4617d08d08cb9092,t-mobile,0,0,1303165,90082,1393247,2022-10-31
176d4c04f4278f80,,438573565,14183336,0,0,452756901,2022-10-31
94ca86b5ea97c25c,mint,944050848,50499408,678920,42685,995271861,2022-10-31
c9dfb1cb1917b0b7,mint,2146179716,42557358,197027,69863,2189003964,2022-10-31
bbc66cc087c51749,,88461056,1676992,0,0,90138048,2022-10-31
0a853a561120f63f,mint,843683465,43335190,671043,57625,887747323,2022-10-31
e0943aa3818e0b2c,at&t,785445648,47009240,21222,4556,832480666,2022-10-31
dd8a32cba30a25c8,t-mobile,1272479020,62311337,1195739,132886,1336118982,2022-10-31
9e46b03dad949e30,mint,479547199,45508480,117308,34803,525207790,2022-10-31
cca4e5d87f1d26b6,mint,483191900,55991518,26517,8923,539218858,2022-10-31
83bc386558b0fb4c,t-mobile,725397263,50179884,139630,20120,775736897,2022-10-31
87ee994276382ce5,metro by t-mobile,497867778,48284775,655328,32366,546840247,2022-10-31
ce25c978a80481c7,mint,3287265680,54709865,2052040,298108,3344325693,2022-10-31
7a626cdee9905744,t-mobile,853867804,52565703,13416,3715,906450638,2022-10-31
35766c029e2311b8,,79412690,9903780,0,0,89316470,2022-10-31
26ea7ab9df2ba728,t-mobile,668300152,56464038,3512,25696,724793398,2022-10-31
121b9a034428b926,t-mobile,599204932,45889673,14428,4479,645113512,2022-10-31
be3a8efd98344ec9,,230440964,8279983,0,0,238720947,2022-10-31
ba69db2fcf404996,t-mobile,353170887,26796194,36607,11701,380015389,2022-10-31
01e576b61b6bbcd5,us mobile,1403395545,78458656,11080,151625,1482016906,2022-10-31
7c4456ab28cb99f4,at&t,490755722,13233081,0,0,503988803,2022-10-31
a586aebf51b7edca,,700927041,49614701,1264289,99433,751905464,2022-10-31
a27ab1c8269d45a4,verizon ,615325479,50546772,1597374,319768,667789393,2022-10-31
4aa0d44f58f9536d,at&t,1185099080,65353904,562539,32857,1251048380,2022-10-31
65e6133300fd5be0,,964144599,59384805,790836,127322,1024447562,2022-10-31
11f8a02b7e44ff0e,cricket,660748808,65541902,14002,3790,726308502,2022-10-31
15aa1ef5b388ca5c,mint,4162910531,103213511,1260221,198229,4267582492,2022-10-31
9bca832c9cad0b1d,mint,704787314,73489203,1074528,163912,779514957,2022-10-31
df38f4733936df9a,,175964609,4723836,0,0,180688445,2022-10-31
276401c6c544f4e0,mint,1505131753,51047433,5450,47044,1556231680,2022-10-31
abddc0526be28bb2,at&t,913073144,45097043,945686,174751,959290624,2022-10-31
2d00dec9b6fd0b23,t-mobile,911523872,49120224,6549,1509,960652154,2022-10-31
a25afc868aa05fcc,,278619102,3290109,0,0,281909211,2022-10-31
1fc078cd770b4e1c,cc network,571897074,15350334,1954260,386546,589588214,2022-10-31
ff928f3643963d14,verizon ,2515866248,65264403,1303903,100562,2582535116,2022-10-31
e10dda376c08b418,verizon ,780554592,63687854,54817,15667,844312930,2022-10-31
ae831662a356c9f7,verizon ,417897745,22034932,958216,125661,441016554,2022-10-31
928e116d11361112,,26909,7545,0,0,34454,2022-10-31
ae57d26429e288af,verizon ,4048363093,100055615,119264,43101,4148581073,2022-10-31
cd564e7f60e2496c,mint,873552177,62216306,60690,24794,935853967,2022-10-31
d6d1a7b7e15a7489,verizon ,826058224,64885397,1797848,249799,892991268,2022-10-31
b08cfc48125ab23c,t-mobile,2762541196,67419138,27554,7823,2829995711,2022-10-31
9c361c80850cf01b,verizon ,646466315,61236816,895497,130740,708729368,2022-10-31
30181ce88a2ed680,telus,797804160,64221531,412079,127774,862565544,2022-10-31
35b62283bfbbb00f,mint,133649777,1112119,21592,147241,134930729,2022-10-31
687bc2b3ca8c8905,mint,1927650577,105383841,692423,87354,2033814195,2022-10-31
16fb67d379291ffa,t-mobile,774435360,25496987,2584014,479052,802995413,2022-10-31
5d1dc810a89979be,t-mobile,529537676,39585817,155860,52293,569331646,2022-10-31
6e2f98401dd52384,mint,618133099,40521426,1033166,155509,659843200,2022-10-31
2863ad46ee0f50ea,mint,2542331461,19845391,0,0,2562176852,2022-10-31
03e3c245efcd2789,mint,806247372,68266937,885431,65954,875465694,2022-10-31
042048ec5fba4dab,mint,897221818,62586969,20627,5582,959834996,2022-10-31
09a165ad10d40ab6,mint,582825438,50792026,21697,6388,633645549,2022-10-31
ac8ccf2aa6343c08,mint,356101449,4597683,668050,168289,361535471,2022-10-31
582b352f5cd0f818,,337853986,17745973,0,0,355599959,2022-10-31
e2b804c7b2ab5e7c,mint,661008849,47690983,1566121,274690,710540643,2022-10-31
31a12003f732d0b3,mint,617774377,50903994,34850,14787,668728008,2022-10-31
6e2546c881249843,,109242147,2096555,0,0,111338702,2022-10-31
43f26b4dd8fdfcee,mint,988469331,39431249,14396,118261,1028033237,2022-10-31
08d17a519b1fdac0,t-mobile,256692498,17829945,196,8582,274531221,2022-10-31
d33f1034c8057b91,t-mobile,686443522,50578867,29290,9096,737060775,2022-10-31
21422749582940b6,verizon ,907249754,55021729,1325699,109057,963706239,2022-10-31
b726620cba6d0692,,508594810,63023938,0,0,571618748,2022-10-31
41c910a717506777,t-mobile,0,0,1962372,282530,2244902,2022-10-31
bf5c131b0de141d0,h2o,702403241,75381631,833658,106907,778725437,2022-10-31
3c7abdbbb37f7fe6,verizon ,584184808,58343406,1068626,177307,643774147,2022-10-31
d9927e67f4b7b3a2,verizon ,545633317,63027827,1600969,186317,610448430,2022-10-31
354ef12f9901f7b8,at&t,409314156,40797944,1761747,288094,452161941,2022-10-31
46e321c09af1c5c0,mint,660654712,29156135,60977,17789,689889613,2022-10-31
57e2a4dcfe247b6f,verizon ,1405696546,65009699,1735451,205491,1472647187,2022-10-31
9a53875ef5481ee5,t-mobile,573069181,64764481,20427,13490,637867579,2022-10-31
1c90f033887fd0da,cc network,897269590,67499110,1166612,204467,966139779,2022-10-31
14e507c92c109d57,mint,787198979,74042589,645150,23351,861910069,2022-10-31
b014e95bd117e47d,mint,737720015,61549664,18641,4105,799292425,2022-10-31
28ae4ef67ce3ee67,mint,464695741,50749819,1244729,264246,516954535,2022-10-31
1c4bb484372b9c6b,mint,805264436,71848144,173,447,877113200,2022-10-31
2efb516d49bbf959,t-mobile,801607270,78681533,664770,42246,880995819,2022-10-31
9727be549c6a6302,mint,817577402,63281250,87125,48367,880994144,2022-10-31
5365bed644ae96d0,at&t,826334302,78400845,63423,25498,904824068,2022-10-31
48b9e9671c49e167,mint,97957310,2926442,44778,19446,100947976,2022-12-31
faf4b1a9beec5735,mint,91259672,2769857,1029796,47058,95106383,2022-12-31
c276dbadf11ce42b,mint,819068408,42610017,1464352,36569,863179346,2022-12-31
4854346d685db8a6,,1164514015,60069192,722701,27555,1225333463,2022-12-31
7813d883c4b13b9d,t-mobile,770736002,39975856,1461594,61249,812234701,2022-12-31
56c7a5f6c1cc942c,mint,570838421,10570247,722501,39943,582171112,2022-12-31
b3abb8ef8447e3be,at&t,958700296,64502007,725405,32851,1023960559,2022-12-31
5141bbd2fc029e27,mint,990939895,52727296,17693,11951,1043696835,2022-12-31
ab143c427c23414c,,942518740,63208417,0,1040,1005728197,2022-12-31
0b937bf0167667c6,mint,176917075,4219746,4456145,1480117,187073083,2022-12-31
735dfaebb5a4fd03,t-mobile,884828363,33829824,1508869,60764,920227820,2022-12-31
e2a4230e879d9c45,,1056297066,71614182,0,580,1127911828,2022-12-31
9e5a3818dbd03bdc,mint,1270328318,64839889,1518877,196400,1336883484,2022-12-31
19cf0b3e0bedc9e6,t-mobile,983057544,76088851,1138,5954,1059153487,2022-12-31
1a293deb3a0a67e3,at&t,1169892051,67610709,1507589,80180,1239090529,2022-12-31
c622001c8ee974ad,t-mobile,1021595042,54279114,1459849,73327,1077407332,2022-12-31
5e9ea08913aa5e8e,mint,1173201101,71916556,32186,18106,1245167949,2022-12-31
cc0de226f5c74904,t-mobile,286554598,15060473,0,0,301615071,2022-12-31
2a3a9c5a9611e4fb,t-mobile,259638191,9165202,1536546,86993,270426932,2022-12-31
a9291c10545bdc90,mint,944369293,78924274,1468252,38152,1024799971,2022-12-31
cf874704718da8d6,t-mobile,1244853,227443,48718,66177,1587191,2022-12-31
c34da203df741f90,at&t,174029566,18324813,798025,95520,193247924,2022-12-31
468c9565a2c7ed7c,mint,994281204,48832187,17587,10486,1043141464,2022-12-31
ec2eaf1cccad6a1f,mint,0,0,47376,14362,61738,2022-12-31
861cf0f5c6421dda,at&t,746576713,43140254,1432774,41525,791191266,2022-12-31
da6bea1922d54873,,390371362,9348600,0,0,399719962,2022-12-31
80831532921d3432,verizon ,351701776,35110289,14516,4536,386831117,2022-12-31
5335fa2ba64c3504,at&t,817364501,54870554,1442290,46369,873723714,2022-12-31
1a668d17993d9ab1,,38071796,2323605,0,0,40395401,2022-12-31
57c0820f86fbd7eb,,177551127,2768846,0,0,180319973,2022-12-31
69473b028509d888,t-mobile,346877933,10651201,1436878,50162,359016174,2022-12-31
c8cdd5564bca44eb,verizon ,1103532717,61128637,752963,26667,1165440984,2022-12-31
2fc8f5a689dd22fa,t-mobile,1964587683,48994570,13770,9884,2013605907,2022-12-31
ee15a3f6ac1d7029,Â ,171680936,11516746,0,900,183198582,2022-12-31
d5fabe2e5239c7c7,verizon ,844176021,59508858,1772534,348192,905805605,2022-12-31
60d6e7d10beb2f75,verizon ,1124971678,59603152,1433187,22301,1186030318,2022-12-31
d0c5da0b2ad26523,at&t,731532175,58848826,805485,45159,791231645,2022-12-31
4f88fe8aadbeb5ad,mint,1348537809,65623401,1466611,43359,1415671180,2022-12-31
28ffc98d061cdd6b,verizon ,787230643,72271238,74319,21881,859598081,2022-12-31
8b0b3b282851b12a,mint,684611098,59043792,41244,12694,743708828,2022-12-31
e81b73a1b6b5026c,verizon ,806916073,65615722,55938,16137,872603870,2022-12-31
6f2e6c3dc644d874,at&t,975067620,74700483,1498188,90216,1051356507,2022-12-31
8e12838c0561898c,at&t,2114419265,46017502,13785,4006,2160454558,2022-12-31
99ddb604eee3aab1,verizon ,719426460,75706519,1487930,80213,796701122,2022-12-31
02503eb0e20e631c,visible,1313589414,82644338,782164,59382,1397075298,2022-12-31
bbba0e8306a5f39e,at&t,1037516704,73316660,65392,34710,1110933466,2022-12-31
2c636afcc40f9177,at&t,0,0,1504677,66917,1571594,2022-12-31
de3688884b82e103,t-mobile,1283005678,57061841,1515480,109238,1341692237,2022-12-31
22500a83e7801504,mint,1090183220,71392454,968192,145198,1162689064,2022-12-31
ae4a6d30c4e87ff1,mint,740115187,51560638,167881,44385,791888091,2022-12-31
587d4a7455770482,t-mobile,536308622,20310804,1470589,408642,558498657,2022-12-31
ec10f20acee74047,t-mobile,1069817555,52844100,732353,21113,1123415121,2022-12-31
e189afc03d327cd1,mint,852288084,63070953,1181792,121911,916662740,2022-12-31
f41fa827e9c9e784,t-mobile,562294879,45732649,7119,1980,608036627,2022-12-31
a5e8ba9c40ccdb0c,tello,780397372,50575337,231,1669,830974609,2022-12-31
2fe3b97ad6aae221,mint,512615835,25353958,9777,2715,537982285,2022-12-31
0efbd85c18781a30,mint,1043867119,80143607,7119,1758,1124019603,2022-12-31
c26261351e49d855,mint,614816832,44370185,1466662,74329,660728008,2022-12-31
3ff801c0fda7ad50,mint,53401664,4327984,2325929,349665,60405242,2022-12-31
0616645c16bb9ac4,mint,925033583,54556533,1120601,66322,980777039,2022-12-31
2371ee6329967ba8,mint,1076359487,51445961,1448191,45273,1129298912,2022-12-31
30f477468c942eb5,verizon ,461332455,50027426,725266,37506,512122653,2022-12-31
d8fb27abb133c5a5,mint,661049237,68208235,47564,13872,729318908,2022-12-31
8f9569fecd9577d5,i.c.e.,674045226,47042601,1463318,112027,722663172,2022-12-31
8f69743200c4e6f7,verizon ,305156228,30481051,1553929,79678,337270886,2022-12-31
5ac9cf0f05dd52bf,cricket,52777,307743,629652,16412,1006584,2022-12-31
211b3c7ccbf92d35,mint,828150679,67101144,733223,38448,896023494,2022-12-31
425a876845f97523,verizon ,1437383753,116550537,1620193,98538,1555653021,2022-12-31
12356435301deb8f,verizon ,663702787,46924240,1492764,63132,712182923,2022-12-31
55fcab787e60eb07,at&t,1080190750,58919594,28845,12903,1139152092,2022-12-31
f9a00f39c7fd5e2c,,555113302,30800316,981594,182734,587077946,2022-12-31
f6747e31dbe82edc,at&t,6315010993,163432885,817424,124654,6479385956,2022-12-31
f67afeb05ef28cfa,mint,954399802,59897475,1515871,58827,1015871975,2022-12-31
53805eab72512ff8,verizon ,551213835,54752795,787233,48611,606802474,2022-12-31
b099d4a5dc7c4937,at&t,1427220570,97045139,793062,45765,1525104536,2022-12-31
b4f8e0a56e5a3ada,mint,1161673830,59022902,1445144,39278,1222181154,2022-12-31
427e25574ec90233,mint,884950713,65126965,22794,12323,950112795,2022-12-31
68be8842b982d40b,t-mobile,260171404,2569355,768318,177586,263686663,2022-12-31
0348d11d6adf3a5b,mint,546793623,38190613,0,170,584984406,2022-12-31
862314a0d19a253d,t-mobile,705551071,68015342,25803,5258,773597474,2022-12-31
284fe7eb99c74d2d,cricket,755365958,13862021,1983324,283530,771494833,2022-12-31
7f2a827bb8174c14,verizon ,2779663870,116119798,3666971,459509,2899910148,2022-12-31
26a4d0609b5724e9,,80500700,1674868,0,0,82175568,2022-12-31
ec2084292c333769,mint,989247981,66499641,1422966,29590,1057200178,2022-12-31
ce103a91cb802191,at&t,430006942,36955809,78516,29453,467070720,2022-12-31
034d7809875bd90a,at&t,1357251176,96912638,2204232,319111,1456687157,2022-12-31
8e215f500cd84898,mint,1491124456,87889281,994746,101514,1580109997,2022-12-31
a4750efa06828e1b,t-mobile,1072294628,68434845,6816,2271,1140738560,2022-12-31
a81d54f52f9fc703,verizon ,466211599,45040020,72183,26990,511350792,2022-12-31
b6fb7aa8bdcf33ba,at&t,1625992016,70399853,774452,35344,1697201665,2022-12-31
f135bb3f6844e43f,verizon ,886946086,66359329,2157714,288928,955752057,2022-12-31
436adff0881a0167,at&t,1384500638,69335261,1733787,142454,1455712140,2022-12-31
719a61a2a825a79c,at&t,12223155209,191444055,1369695,30689,12415999648,2022-12-31
164a0cab5321e827,verizon ,886073346,79340227,0,0,965413573,2022-12-31
8062ea7a79b08b7b,at&t,1009976125,55872007,1139810,99739,1067087681,2022-12-31
ab4838f208760830,xfinity mobile,857676065,71765296,71854,27936,929541151,2022-12-31
1fb0b90fc8e7a4e5,verizon ,795563373,64051693,291315,49676,859956057,2022-12-31
49710469237bbb3a,mint,852055723,63934834,778856,418877,917188290,2022-12-31
0c11facad62e8a19,,745318492,42218553,0,0,787537045,2022-12-31
443afdc0e2299fbb,cricket,505219780,48041356,6899,1964,553269999,2022-10-31
b64ddf252b887792,cricket,724895201,69161022,1584117,333203,795973543,2022-10-31
1d9579a86c947783,verizon ,4233406494,91299052,400550,40065,4325146161,2022-10-31
39c3290e998333a6,verizon ,242854677,25309328,84,84,268164173,2022-10-31
2d4db3b56428662b,verizon ,4883916249,131695920,1910658,263308,5017786135,2022-10-31
ef530b501a1060c9,verizon ,810099589,60150310,225,85,870250209,2022-10-31
7667034298502e9a,mint,373827945,24586331,29891,8895,398453062,2022-10-31
e9b326b1cc9285ba,at&t,284892141,27458155,1792946,435863,314579105,2022-10-31
6165d07206778346,mint,638300992,68385488,705803,136630,707528913,2022-10-31
b2317bb324c74e3a,verizon ,140737346,22185496,1514438,216413,164653693,2022-10-31
4fb3f09000349805,verizon ,339956446,25098353,1914622,279812,367249233,2022-10-31
61b964e478a14e97,verizon ,445483499,56689183,2480880,465449,505119011,2022-10-31
af10639d743cb9fd,t-mobile,451900933,60881368,1035985,186597,514004883,2022-10-31
a0ca8259523a95ca,at&t,421769770,6996762,975262,132763,429874557,2022-10-31
88f7b0c824d04bd2,at&t,1181266183,72026942,1294283,122718,1254710126,2022-10-31
7fbdb35daa4bc386,verizon ,495876466,50745664,1176464,183476,547982070,2022-10-31
7ab33f126276f4f1,mint,643997551,39487936,21861,5369,683512717,2022-10-31
c23e42bfeee0c43a,t-mobile,505548223,35338553,7822,1998,540896596,2022-10-31
52aa21a7e57b6f12,mint,712123308,38636862,498,2750,750763418,2022-10-31
133a438bdba64300,mint,95344385,9930601,1992598,338971,107606555,2022-10-31
c0cc4e976c3b0a41,t-mobile uk,914234242,57823856,1311416,71465,973440979,2022-10-31
5d288d39c44f8f3b,mint,1555754317,80826754,6057,1114,1636588242,2022-10-31
93b1572f0834715d,,1807045724,65025499,851836,119695,1873042754,2022-10-31
5dced12e78be56f1,mint,3984176630,68210009,652009,53761,4053092409,2022-10-31
075cd53166cbab87,mint,1105141370,39804037,0,24,1144945431,2022-10-31
e97b2e3abca5bc3f,,302265132,18907726,0,0,321172858,2022-10-31
30f8dd8c1767d243,mint,838867110,57441277,665829,52919,897027135,2022-10-31
fc8806a0b361d35f,verizon ,429429714,12293751,1289652,58664,443071781,2022-10-31
3569d129d4e9e921,mint,6090319005,76152465,875767,141907,6167489144,2022-10-31
ede6bc82eecf4834,mint,3093929956,62744737,1904085,305984,3158884762,2022-10-31
37007839a7b8d891,mint,484079718,26835249,7822,2487,510925276,2022-10-31
d9c072fb16123bd0,,141547207,3183270,0,0,144730477,2022-10-31
07d706d0a35cd5d6,mint,2163547475,76709257,1339245,89895,2241685872,2022-10-31
778497e656bc7cfa,metro by t-mobile,4755304158,67444809,654172,48800,4823451939,2022-10-31
456c6c335a70bb40,mint,621147002,35297320,1011309,164289,657619920,2022-10-31
847be5ee6c310ec8,,2006406615,27918156,0,845,2034325616,2022-10-31
50444e04569928e2,mint,898604784,45136815,698726,58552,944498877,2022-10-31
6e55cec6ff168fe9,mint,2301272637,55167750,34657,321954,2356796998,2022-10-31
4d1ba1162e1d2aa6,t-mobile,1108086902,46479011,7153,2440,1154575506,2022-10-31
991b5b0cfe7bba35,t-mobile,972605323,86862647,6549,1581,1059476100,2022-10-31
f087e9c6dabcfc25,at&t,636302642,40444283,9236,12662,676768823,2022-10-31
d2d80fb58762d5d4,verizon ,719820087,13653174,1702073,553896,735729230,2022-10-31
aed7ea319aa0e833,,240496460,3158553,0,0,243655013,2022-10-31
dfda7b7e8b679784,t-mobile,1162173031,59019673,2023656,371982,1223588342,2022-10-31
c4b7b64c441a9c99,mint,857507003,78470295,13807,3969,935995074,2022-10-31
2c2ebee5f339c4a2,at&t,1115362640,72476594,791199,83201,1188713634,2022-10-31
0a74fd3abe9c4c2e,mint,1657855450,61302605,988020,124108,1720270183,2022-10-31
e850336062d3c209,t-mobile,735078064,81510195,1403328,292946,818284533,2022-10-31
3496a3bcf44b260b,verizon ,686541445,44543202,157816,76188,731318651,2022-10-31
75c756001e7d7c99,verizon ,665301390,62774039,6297,1782,728083508,2022-10-31
0534d8311c55749a,verizon ,0,0,1442209,63348,1505557,2022-10-31
8d906ee89ff8c346,t-mobile,158536447,4889794,2015478,312742,165754461,2022-10-31
f7e5484a01491f1a,mint,736660478,62613882,1281604,224020,800779984,2022-10-31
636fbfe857ff3066,t-mobile,157398750,7446488,261422,102587,165209247,2022-10-31
b2794396e17e9c61,,86652618,1926904,0,0,88579522,2022-10-31
738dd0f9735c094a,t-mobile,2115744202,47061409,6329,1740,2162813680,2022-10-31
792844fc2e2faf14,mint,906002624,55617576,6493,1607,961628300,2022-10-31
dd37c44630e839dc,mint,565673306,60112163,736705,155786,626677960,2022-10-31
c2adb779ed3b1772,t-mobile,3028813557,48412476,1334571,100714,3078661318,2022-10-31
c95fdb851c6c5cf3,,69297642,1498480,0,0,70796122,2022-10-31
024ecd5c7ca4a146,,155961457,2791204,0,0,158752661,2022-10-31
21d0a67971234845,mint,1941250602,45487128,173578,9595,1986920903,2022-10-31
6c45a4c40c36047f,t-mobile,0,0,1312266,69971,1382237,2022-10-31
a94aa1f654efb2f0,t-mobile,1790564942,86613207,111189,48004,1877337342,2022-10-31
5ec0fbdaef385875,Â ,1329671875,63472959,622999,19394,1393787227,2022-10-31
d1507b4033bf38a3,verizon ,1569463194,43385894,1636562,162517,1614648167,2022-10-31
111631b39bcae464,metro by t-mobile,9388928529,211620433,1414287,76269,9602039518,2022-10-31
a2ead54e5a551237,at&t,1110432006,79778080,13612,3835,1190227533,2022-10-31
360ed2c1ddaead12,,67953237,3196915,0,0,71150152,2022-10-31
a61958b3cb3acab4,access wireless,2429030911,117523864,6672,2100,2546563547,2022-10-31
ab72fe116cfc3782,,159278069,2623793,0,0,161901862,2022-10-31
8ded9a71f84dd4ee,,78240079,1530639,0,0,79770718,2022-10-31
192a7fcbdda4b46b,,154423698,2205188,0,0,156628886,2022-10-31
f12f2a0799667eee,,154927376,1559440,0,0,156486816,2022-10-31
c6d4d1a57b686e2d,,154981294,2415600,0,0,157396894,2022-10-31
e23d241d860fa7bf,,154436088,1671372,0,0,156107460,2022-10-31
70983e564d10455b,,165241476,3640925,0,0,168882401,2022-10-31
13f372063ecb1598,,165487681,2456785,0,0,167944466,2022-10-31
4e98e29035bb3cf9,,154610070,1976975,0,0,156587045,2022-10-31
59258d0c6f688e9b,,154464590,1788531,0,0,156253121,2022-10-31
c277bb1370e4c485,,154345680,2458400,0,0,156804080,2022-10-31
c4f358d170b12176,,154727007,1468396,0,0,156195403,2022-10-31
039d42b8cb24540d,mint,708699820,24816499,13081,5095,733534495,2022-10-31
77ed28b6a3c46477,verizon ,339839194,8226189,1899860,263027,350228270,2022-10-31
ff6429f779d1bde8,verizon ,813019979,30268997,153932,53512,843496420,2022-10-31
712e3d8943e3dfef,,3421450617,79455967,0,0,3500906584,2022-10-31
d16c51b296be9dc8,t-mobile,1636740200,31322457,14450544,749302,1683262503,2022-10-31
ae0cc02fda96d62d,,205398129,6199491,0,0,211597620,2022-10-31
685bf7c7f6dc4541,at&t,783604508,35834590,667343,86722,820193163,2022-10-31
ed530054bf632f17,t-mobile,1846430710,23365121,375150,129774,1870300755,2022-10-31
3eb1343f399af04b,,191802753,3829367,0,0,195632120,2022-10-31
67e16e83b092e6fb,,80783726,1829330,0,0,82613056,2022-10-31
c1469cebb7c3cc45,,194016018,3990152,0,0,198006170,2022-10-31
e1fa144d18498503,,115295239,2420471,0,0,117715710,2022-10-31
85a9723372373b88,,265929416,3224835,0,0,269154251,2022-10-31
8efd3f9bb840f561,cricket,245094522,6364148,680103,103547,252242320,2022-10-31
a66bb5f7f51be24b,,71284528,2786886,0,0,74071414,2022-10-31
71b7d49708b36211,,76857397,2914198,0,0,79771595,2022-10-31
1b9f0056efe042b1,,214568985,2618616,0,0,217187601,2022-10-31
c71084f66eedc458,,189016283,2272707,0,0,191288990,2022-10-31
fbea2289e7a56e20,at&t,772831154,48314986,1439717,33261,822619118,2022-12-31
3349d45186e58bab,mint,485944552,20201989,767411,215985,507129937,2022-12-31
89dbcfa4f9ceba92,t-mobile,745606664,54546345,2490720,331119,802974848,2022-12-31
40443311735d3aff,t-mobile,1275184575,57491658,713842,18043,1333408118,2022-12-31
64f5995ea0b1c779,mint,863608837,56737860,38356,18117,920403170,2022-12-31
044e248ef83e7a11,mint,476572643,31777946,160320,13868,508524777,2022-12-31
f348ce2e3e63617b,mint,2584705687,87027282,1465708,209152,2673407829,2022-12-31
fa700080ad8cccc0,hello mobile,1240062110,72963655,1427809,37583,1314491157,2022-12-31
ace6ef05a7963a09,mint,1890832655,65982351,2180930,227357,1959223293,2022-12-31
126284a0178e9350,verizon ,559386092,47914426,902628,111871,608315017,2022-12-31
b7bc24764920f519,mint,152131986,1217074,578,4863,153354501,2022-12-31
d62f0b2dd067bab9,mint,510804544,41818673,746119,43960,553413296,2022-12-31
bf400ac57799807f,at&t,825715598,36718772,1420409,19457,863874236,2022-12-31
347d5b5f0860d6fa,mint,696449699,44592200,1467345,47907,742557151,2022-12-31
07d706d0a35cd5d6,mint,614088629,39904548,0,65,653993242,2022-12-31
778497e656bc7cfa,metro by t-mobile,1395055859,60801809,1457663,56450,1457371781,2022-12-31
d057fd374c8e0a5d,t-mobile,1127708637,21873307,2276,15856,1149600076,2022-12-31
51daee294e84feef,mint,749580104,84053260,29992,11483,833674839,2022-12-31
269e40fe13b6ecdc,mint,1100987730,45641683,892505,109287,1147631205,2022-12-31
1baf042131cc0c3a,,127618626,2484839,0,0,130103465,2022-12-31
b1510bd896941221,t-mobile,715246718,47890038,23416,11222,763171394,2022-12-31
991b5b0cfe7bba35,t-mobile,1084973268,89337438,84574,32623,1174427903,2022-12-31
f087e9c6dabcfc25,at&t,1196743725,62393214,115,536,1259137590,2022-12-31
d2d80fb58762d5d4,verizon ,835130356,71314718,1741824,148564,908335462,2022-12-31
aed7ea319aa0e833,verizon ,1232265713,52342115,764670,50839,1285423337,2022-12-31
dfda7b7e8b679784,t-mobile,521439022,17282675,1492170,94387,540308254,2022-12-31
c4b7b64c441a9c99,mint,1055714521,78202681,1542519,445019,1135904740,2022-12-31
2c2ebee5f339c4a2,at&t,1610848854,95956840,788270,31309,1707625273,2022-12-31
dfce64fa2a23968e,verizon ,1411824397,27571610,1489850,70190,1440956047,2022-12-31
9d0cf7eda3a008f3,mint,256779818,13801720,2073,26865,270610476,2022-12-31
c0dd29b9b13d28c1,verizon ,1068293893,44070555,1459198,64098,1113887744,2022-12-31
38da7f63b2d23938,verizon ,463486612,15170216,2991716,364398,482012942,2022-12-31
0b50b6404fdab3ad,verizon ,969728139,65822610,1420863,28456,1037000068,2022-12-31
a3eb1f5786e10294,at&t,1164294777,71227220,1429436,45529,1236996962,2022-12-31
d55164ac2220e21d,mint,865997213,58829934,29174,8113,924864434,2022-12-31
6b400f490b3a9756,verizon ,1034230903,69919076,710322,19059,1104879360,2022-12-31
8b0da85f5aafea9f,mint,652294164,17465322,2690989,479014,672929489,2022-12-31
f597376f0a19d323,,159778654,2798608,0,0,162577262,2022-12-31
f692f238261f9f68,mint,1203247683,74263551,1997155,207284,1279715673,2022-12-31
84580ec21ec9259c,,463469222,24500846,0,0,487970068,2022-12-31
2b59beee65fee938,,176474031,7998994,0,0,184473025,2022-12-31
28d6e8bfd6ba4773,,85909443,2102382,0,0,88011825,2022-12-31
94b2efd2577270f2,,175357923,3186582,0,0,178544505,2022-12-31
1ea3f1cc5c070378,,184545985,3339808,0,0,187885793,2022-12-31
d0fd77a4ad092c63,verizon ,1354212017,88043640,1523378,87212,1443866247,2022-12-31
234127bc87022e82,t-mobile,993950739,70463666,326560,113389,1064854354,2022-12-31
fa54df018e8c50fd,t-mobile,2958284444,97581996,154711,63471,3056084622,2022-12-31
4dc679aadd471fa5,verizon ,1103053303,67685240,13376,3485,1170755404,2022-12-31
cfea2a796a9957fb,verizon ,958727779,75970400,54716,15911,1034768806,2022-12-31
a5c6ed1d3cac2762,,8912918220,127837483,1503782,153406,9042412891,2022-12-31
270d602c3585984f,metro by t-mobile,0,0,773645,42312,815957,2022-12-31
ef6492a6255f1840,mint,963061603,75935165,1194202,238275,1040429245,2022-12-31
0896a28f381596c5,,118693628,1993354,0,0,120686982,2022-12-31
1546bdc77a494b0c,,243616704,3269484,0,0,246886188,2022-12-31
0af554a98d42ead8,telus,490470316,21476323,23291,12894,511982824,2022-12-31
fb23074a25481ae1,mint,869942090,87425438,1474210,89136,958930874,2022-12-31
bfc615ac4d4a77d0,us mobile,3882189607,65368271,36628,12616,3947607122,2022-12-31
65d23ae36fe660ad,,154490145,2076749,0,0,156566894,2022-12-31
f783c6225ee9d82a,,154433549,2692350,0,0,157125899,2022-12-31
d019b487ff642ec2,mint,494555301,29526889,79536,28373,524190099,2022-12-31
f96c5fab18bb0656,mint,735060711,45165667,9719,4851,780240948,2022-12-31
fa780fec5e3e64e5,telcel,1357989726,75015119,7713,84210,1433096768,2022-12-31
499dcdf131c76d83,mint,450766565,28192423,986771,110164,480055923,2022-12-31
6be883858a39151e,,193406109,1753148,0,0,195159257,2022-12-31
e9d0235a1a89f5b0,at&t,0,0,1263128,102140,1365268,2022-12-31
72c64cbb9fae03d6,spectrum,659121603,70063034,1446430,241946,730873013,2022-12-31
2c62eaec596e36f5,mint,826623952,57664751,1447102,47824,885783629,2022-12-31
64515e1f05c88340,pure talk,1237789733,97835926,1475860,269299,1337370818,2022-12-31
b542d568c5eec705,verizon ,1162864075,83524620,13339,3397,1246405431,2022-12-31
62eec797c6867937,at&t,351557573,29681723,730847,62010,382032153,2022-12-31
19b84a32aa9589a0,orange f,1107615576,82148570,347501,97659,1190209306,2022-12-31
49ff7b55aa916b66,verizon ,769701482,55730884,15004,3958,825451328,2022-12-31
9d7cd8c2fd4f971d,mint,1844203810,90521758,722995,26933,1935475496,2022-12-31
0036cd1de5f2fbee,,166176273,1539444,0,0,167715717,2022-12-31
f5b1309f66fabb21,,260027519,3770712,0,0,263798231,2022-12-31
343082ffd3a21fd3,mint,2837612890,40048156,1423680,45144,2879129870,2022-12-31
7d062eaf047717ea,,166552952,2701664,0,0,169254616,2022-12-31
c9420d08de980301,,612253264,9038265,0,0,621291529,2022-12-31
b7cb88a76d9887b3,t-mobile,1011143446,32558244,46383,12484,1043760557,2022-12-31
33a2506e2e949934,,80536070,1754198,0,0,82290268,2022-12-31
80699d0eb011d678,metro by t-mobile,2527992410,105335588,24725,16823,2633369546,2022-12-31
56b48754d39b7547,mint,698879408,24232662,2496,46378,723160944,2022-12-31
251dee5fff66fd79,verizon ,914250708,97473642,4417096,1720684,1017862130,2022-12-31
c36d46ac75242c7a,,59670627,2503270,0,0,62173897,2022-12-31
98e3cfbb2d134321,mint,1661936726,32050770,1501538,60237,1695549271,2022-12-31
f3f99c0535cc5c6a,at&t,1079666521,47488041,1455154,40199,1128649915,2022-12-31
7bebf8e6d530ab45,t-mobile,8129582360,119384244,66125,25820,8249058549,2022-12-31
58f14488868bb7b5,xfinity mobile,1089860910,81241607,2653003,519864,1174275384,2022-12-31
8e097389e749284d,verizon ,3077333139,44739293,1442013,49422,3123563867,2022-12-31
b13df3088fb1fe14,,164320237,2730507,0,0,167050744,2022-12-31
a6d1a46a179f4081,verizon ,2131895690,76117606,1485730,58298,2209557324,2022-12-31
9784073500d4f35b,mint,2324062897,30527040,27071,7906,2354624914,2022-12-31
5d9b927a1b909144,mint,1030718133,10482495,1516736,82204,1042799568,2022-12-31
b23c397bcee14e15,mint,232044167,13892471,0,0,245936638,2022-12-31
1b1214f05d6ffa19,,135360915,2760535,0,0,138121450,2022-12-31
70f8992c2b2140e1,at&t,1682355942,29866026,1847697,191361,1714261026,2022-12-31
84cd9f09358d6d1e,t-mobile,1366963771,72589881,56979,17077,1439627708,2022-12-31
e590e3730efbb8c5,,157466620,1611499,0,0,159078119,2022-12-31
94ffae4c968ec5e8,mint,2568039161,67469875,1447589,65620,2637022245,2022-12-31
47eb1bc382b8b9f2,t-mobile,127243248,12228651,1443453,55935,140971287,2022-12-31
5306881216de9bb7,,56154265,2064804,0,0,58219069,2022-10-31
163bb2547bbfe4b2,,66716891,2088737,0,0,68805628,2022-10-31
e6e2e66f8d6e68ef,t-mobile,2287566100,110597843,40854,18948,2398223745,2022-10-31
00acaadc9b5c43f3,,33187,10818,0,0,44005,2022-10-31
af6172ce1cb61b45,t-mobile,0,0,0,0,0,2022-10-31
4058c9688639db5a,verizon ,940886955,84183712,6661,1845,1025079173,2022-10-31
ac3bfd480d19e67b,verizon ,0,0,0,0,0,2022-10-31
6ca6ab705dbeb12c,,2003045306,43595830,0,0,2046641136,2022-10-31
3948a736a6e14321,t-mobile,744505143,56274271,909911,139227,801828552,2022-10-31
0f0047f47b031ddf,verizon ,92000824,1603962,51016188,1493479,146114453,2022-10-31
0f8de336058d7c72,verizon ,212393117,13255140,13409,3809,225665475,2022-10-31
64c9ef58f4f30b3f,t-mobile,1636,2873,15237,5815,25561,2022-10-31
e6adf7161a98f85d,t-mobile,1123454322,96775260,6565,1948,1220238095,2022-10-31
b48c873297ff4645,t-mobile,65836,65433,159280,1552388,1842937,2022-10-31
50b5083089b03e26,t-mobile,3963303080,79641959,307,3771,4042949117,2022-10-31
944232d58933fde8,t-mobile,0,0,0,0,0,2022-10-31
67ad7d59497660b1,t-mobile,29910,134275,0,104,164289,2022-10-31
914cd1ec775c0377,t-mobile,871106,397193,0,0,1268299,2022-10-31
1f53ca2f6258dc64,gci,2814117749,94167675,0,0,2908285424,2022-10-31
e0da516fc9dfba7c,t-mobile,500533791,13346037,189017121,12375507,715272456,2022-10-31
196f554b55be8974,t-mobile,6185501154,161186554,28755,10354,6346726817,2022-10-31
48df501f9645c6ce,t-mobile,2682238454,86863682,35902,9274,2769147312,2022-10-31
41f1dba51aa5943f,verizon,0,0,0,0,0,2022-10-31
2f16c8fd36d581ae,,946542,247500,0,0,1194042,2022-10-31
030d16b40440c472,verizon ,459758,154654,33450389,937854,35002655,2022-10-31
2244a24532111dc5,verizon ,607667,373711,14384,3451,999213,2022-10-31
14663067142737a3,,810028,232036,0,0,1042064,2022-10-31
22be631e812f3f26,,67312242,1658586,0,0,68970828,2022-10-31
e56f610f04db1eb4,,44812374,1321680,0,0,46134054,2022-10-31
34e021ac3f364162,t-mobile,790,910,1065322,330085,1397107,2022-10-31
14b26c16c0be1ac4,verizon ,4538176939,124086824,752707,80880,4663097350,2022-10-31
3d75401a3f834e50,mint,3672140594,93517924,0,69,3765658587,2022-10-31
c89c7e2358496603,at&t,91459,264086,136796,44049,536390,2022-10-31
5ad02ed408786bee,,739112,278846,447739,167010,1632707,2022-10-31
09da734de43c355f,at&t,111630526,10468142,2379235,383858,124861761,2022-10-31
162651928b95343d,verizon ,0,0,0,0,0,2022-10-31
13473949525154b8,,952253997,63650141,1266882,268115,1017439135,2022-10-31
343c57ac5e8da19b,,2252327,482277,114285662,3619724,120639990,2022-10-31
6a1841d7ac4993f6,mint,2913647506,71161790,43840,148050,2985001186,2022-10-31
19840edf68ec198d,at&t,2746528915,89544128,932895,157030,2837162968,2022-10-31
c835dd4c7613f1f2,at&t,213138538,2979881,855147,265585,217239151,2022-10-31
022fd381a9d838e0,verizon ,100878768,2282451,71897330,895357,175953906,2022-10-31
6b61541a6335c106,,39594227,5365469,166414,54345,45180455,2022-10-31
65fc91219444af86,,42490417,527690,12961,17889,43048957,2022-10-31
14529d0bd151e882,at&t,0,0,0,0,0,2022-10-31
4a9b6c865204c480,at&t,865774,292590,14933,3450,1176747,2022-10-31
ed3b0680f74d2e59,,860271,474188,776162,258362,2368983,2022-10-31
6766ce01b8c7a271,mint,879452,264649,154437,53851,1352389,2022-10-31
5652a176973b51c6,,974438,286071,21100,5935,1287544,2022-10-31
9d5a9aa85668d8da,t-mobile,984422709,66346334,208,208,1050769459,2022-10-31
8cad342c4fbb3f71,mint,556404044,54768147,614467,28588,611815246,2022-10-31
03060ceff897ec8b,t-mobile,725392,219203,578120,218500,1741215,2022-10-31
edc33dba98853372,t-mobile,753725340,30654186,0,0,784379526,2022-10-31
b8d28cc86fa2aaeb,tello,1263277907,52893102,2487,1835,1316175331,2022-10-31
d4dbb073a19c8bf8,verizon ,864462,115005,663525,66826,1709818,2022-10-31
aeefaeb68e072d52,verizon ,5109817808,141290556,1554277,161560,5252824201,2022-10-31
bf970aed4031b6b6,verizon ,136883,20125,983349,311556,1451913,2022-10-31
68da467c986a201d,,197885674,2233415,0,0,200119089,2022-10-31
97839d9782b914dd,verizon ,20920959509,394696345,97081,36004,21315788939,2022-10-31
8f05172f9e6a7633,,784649,268298,0,0,1052947,2022-10-31
2205bb5b56ce65fc,,1119987127,40294824,0,0,1160281951,2022-10-31
c138cc508ccedc41,metro by t-mobile,0,0,910651,385464,1296115,2022-10-31
98643eb073b2537c,mint,198035,133592,314842,362455,1008924,2022-10-31
9c877f9f011a787b,,5440027803,88995967,0,0,5529023770,2022-10-31
32f1572e7df49b27,t-mobile,1196236393,75303194,15181,4822,1271559590,2022-10-31
b4292e057cf8b257,mint,0,0,949445,334791,1284236,2022-10-31
bb1fc8e43029ea33,,770213609,13146015,0,0,783359624,2022-10-31
e2b60d77f9a9d9ad,,28585325,931516,79029,39735,29635605,2022-10-31
3e2301fa571199f9,verizon ,178520,47108,238837,59523,523988,2022-10-31
664aaca5d4c8acb0,t-mobile,164139385,2367928,91191,148119,166746623,2022-10-31
1ab70d251372db2a,,686842,249281,48230,6987,991340,2022-10-31
e18d1d32041f6209,,152532947,2412124,0,0,0,2022-10-31
68a8270f0c56baa0,cc network,791382115,49986151,84793,26750,841479809,2022-10-31
0faa9ce923af204f,verizon ,0,0,160202637,3488703,163691340,2022-10-31
1f19ad4d706787e9,,28360187,1477836,0,0,0,2022-10-31
3f4046059784598c,mint,85567,34281,0,0,119848,2022-10-31
fa6198dcf8cee052,mint,676899447,73042936,1904419,252057,752098859,2022-10-31
3060ab93386bddca,mint,134475374,2665689,14988,159861,137315912,2022-10-31
a6ab4d1416d81325,verizon ,5177466,322668,13463,3737,5517334,2022-10-31
407c280953badcad,ting,7554,3084,0,0,10638,2022-10-31
b331824fe46aa150,,8164,1938,104,104,10310,2022-10-31
c6f2612de6b2d04f,,20329,6697,0,0,27026,2022-10-31
dee6e1806c075a54,verizon ,2568,699,1034,17456,21757,2022-10-31
8937f18905a5ddb9,,736933358,18225439,0,0,755158797,2022-10-31
fd107f4492dfbe80,t-mobile,792484,251702,0,0,1044186,2022-10-31
13bde66d6b8e95ea,verizon ,607862529,52831262,485272,170697,661349760,2022-10-31
bbad430bf8be4ca7,verizon ,640792,181124,342679,141123,1305718,2022-10-31
8dfa7919955a682b,mint,141805055,2849785,0,0,144654840,2022-10-31
d31565334541094b,,27793,9472,0,0,37265,2022-10-31
3087d4492b62c370,verizon ,242484968,12421235,1218956,279362,256404521,2022-10-31
9a4a2503bc454b5a,,182963082,3826020,0,0,186789102,2022-10-31
1822cd3041448fa6,t-mobile,31092812380,396653034,70913,24176,31489560503,2022-10-31
3b4aea5e47ef239b,,232501276,3202790,0,0,235704066,2022-10-31
945d7b9fe6120c0a,,586327,179571,0,0,765898,2022-10-31
e8c0c1add25e35cd,verizon ,678175414,56975194,84938,36156,735271702,2022-10-31
01afac58774ec9fb,mint,4060291137,121810588,1548320,222326,4183872371,2022-10-31
250c62c8ece18593,mint,978196111,88059913,73670,6957,1066336651,2022-10-31
d91cf4dc35bf0015,t-mobile,542484072,72599289,146754,42996,615273111,2022-10-31
e603743d233dded6,mint,113017684,10420314,3476,20570,123462044,2022-10-31
fbf5531123f71dc2,mint,0,0,27604,115876,143480,2022-10-31
c5d0b3ff5130d159,mint,857480,213583,164807,42776,1278646,2022-10-31
30ed20b1aa31b21c,t-mobile,5936949684,129336065,631049,39162,6066955960,2022-10-31
21bf014f5c47ac13,,98143623,3089002,0,0,101232625,2022-10-31
8b7e2cc9790658b0,t-mobile,1503036759,36011312,6791,2033,1539056895,2022-10-31
fe9bf99e476a4421,t-mobile,837422961,62503486,6554,2235,899935236,2022-10-31
b8fd6bebbe8ea147,,75165947,1895106,0,0,77061053,2022-10-31
92a6916e9985e4ea,t-mobile,4191298248,134389113,17905,5690,4325710956,2022-10-31
c66696e19d5652f0,mint,15604623786,346173747,881061,120004,15951798598,2022-10-31
76badef8b3052975,t-mobile,6991,2483,494634,1906698,2410806,2022-10-31
ebface9c5751c217,verizon ,448916522,32437499,42910,17140,481414071,2022-10-31
4ade9cb9a704bfee,,200775285,16803723,14814622,446937,232840567,2022-10-31
e206376d0f55fb1d,t-mobile,490554,180067,694797,252920,1618338,2022-10-31
7532dd5a4d584ce5,at&t,0,0,0,0,0,2022-10-31
c4d2d06d7310f2f3,verizon ,859385347,71767508,702548,55192,931910595,2022-10-31
bd02348ae6b191fd,t-mobile,323288632,28106104,14146,6304,351415186,2022-10-31
7aece37bfebe8dc7,metro by t-mobile,0,0,126643076,2285773,128928849,2022-10-31
95b43d537a72cb3a,verizon ,0,0,2203118,436026,2639144,2022-10-31
20f38c1e141f8e9e,,68063839,3892367,0,0,71956206,2022-10-31
167626bb1b5561a3,t-mobile,0,0,658294,38340,696634,2022-10-31
397f487ca5782cc3,t-mobile,658682,225934,400579,138799,1423994,2022-10-31
48e853f5c19f8270,t-mobile,0,0,1211997,295314,1507311,2022-10-31
a58ecc09ab66d6fe,,3409082454,77540180,0,0,3486622634,2022-10-31
a21697318392f1bc,t-mobile,650641151,78865356,41919,14668,729563094,2022-10-31
81ec133874b72423,mint,760281,244806,342910,139333,1487330,2022-10-31
a080d08a6e084a71,wireless,787618549,84337370,627742,128902,872712563,2022-10-31
59c08bb5144e08cc,verizon ,208168186,6807759,65271,26761,215067977,2022-10-31
35488f825d0c9d0f,t-mobile,197904,82460,68607,97310,446281,2022-10-31
346602caf00263a7,t-mobile,411255431,21184407,80849,31412,432552099,2022-10-31
b90b79d86451dc5a,,469468,139092,0,0,608560,2022-10-31
20e57ff086da3f26,,19897,17259,300928,91828,429912,2022-10-31
ccc5772116312c4a,t-mobile,443420180,16209052,42619,15408,459687259,2022-10-31
279a0c356c78bcc9,,429485834,12540503,0,0,442026337,2022-10-31
2e8c2c1796df6fbd,ting,0,0,20078,10031,30109,2022-10-31
1f78a28c9da8a46d,verizon ,641955899,12116542,129431647,1342584,784846672,2022-10-31
07f7f51e000a9df3,,594171,163975,0,0,758146,2022-10-31
d1dca2a1fbc9ab8c,t-mobile,722305962,74085966,7398,2732,796402058,2022-10-31
c90c7e116ae49f08,mint,471255709,59999066,20172,13794,531288741,2022-10-31
46fe7fc84b5bf6e2,t-mobile,654652290,59885070,966347,173311,715677018,2022-10-31
80d43e261fa7a938,t-mobile,421198030,53542493,690214,159730,475590467,2022-10-31
1757e4eee59b9d9d,t-mobile,890210,237167,93004,18171,1238552,2022-10-31
de52a0522cf8d999,t-mobile,582925101,64675770,7007,2349,647610227,2022-10-31
d33ed229479a29c3,,4371319878,116137842,7116,2421,4487467257,2022-10-31
3a41ec714b5e9ff4,t-mobile,814564155,16734619,104,104,831298982,2022-10-31
daa2195bd360d89a,t-mobile,795847,270596,16035,5773,1088251,2022-10-31
f0e79d817ed1d9c5,cricket,1512873,309784,63356,17909,1903922,2022-10-31
3cb9e3346fcef08c,,651728,183884,0,0,835612,2022-10-31
7847151908c2127c,verizon ,0,0,1961560,284981,2246541,2022-10-31
508adb081dc9c5b5,at&t,38640503,755720,16020,3564,39415807,2022-10-31
1d68f8ef0342ee5c,t-mobile,543625105,6468015,8853,3445,550105418,2022-10-31
150eefd40c402d55,at&t,17163,7641,0,0,24804,2022-10-31
e04a5d0fd076df1f,t-mobile,420081255,35271341,8252,4531,455365379,2022-10-31
f4a1f80776b98e19,t-mobile,0,0,0,0,0,2022-10-31
7e3a085113324ef9,,478176148,52126072,0,0,530302220,2022-10-31
d15aecd5674cbfa0,mint,63767424,1044990,1080709,445237,66338360,2022-10-31
9eef99b649df8409,mint,782200051,76836082,4574,1642,859042349,2022-10-31
4f0ddad05d9bcdbc,,220118,110409,0,0,330527,2022-10-31
2a71ee81611eea9f,metro by t-mobile,188965406,2706541,29439,12673,191714059,2022-10-31
93613d922c31f1bd,,726162,209078,0,0,935240,2022-10-31
c0e76a8962b2221c,,106214365,17447170,0,0,123661535,2022-10-31
2e7764326e41a686,verizon ,252732081,4105256,169437,71074,257077848,2022-10-31
c2a426211cf2cfaf,mint,0,0,0,0,0,2022-10-31
03f3f69201daab15,t-mobile,94716759253,1194009781,0,0,95910769034,2022-10-31
10f4617370573c69,verizon ,0,0,49730,12674,62404,2022-10-31
e571a5612c5d5f70,verizon ,6385914,185790,3260034,110111,9941849,2022-10-31
80e60e6a789d8639,t-mobile,30211,18256,104,104,48675,2022-10-31
b385c21660904be2,mint,433367,147704,83500,31373,695944,2022-10-31
7775ea5b8fe8fd36,,227123860,32676882,169274,31135,260001151,2022-10-31
6c8bc327c7741231,,784787,224447,30016,10235,1049485,2022-10-31
d0798d0ee8efe4c9,,799585,300944,0,0,1100529,2022-10-31
15620e0456bf2475,,256652,67551,715866,259175,1299244,2022-10-31
0d812b1b4c31319e,t-mobile,772985191,65224814,879955,135048,839225008,2022-10-31
86d578247e4629cf,us mobile,494430429,26296153,601057,41537,521369176,2022-10-31
045cf40834f1275d,mint,277833,110669,18753,6900,414155,2022-10-31
bf175ecac1812fca,,698691118,77392342,0,0,776083460,2022-10-31
8a6f39f55c20a34a,,905505,458889,66553,29941,1460888,2022-10-31
68f1fd74898596fa,mint,851790,241553,358157,121696,1573196,2022-10-31
d60c5c73832ae31a,,664611,196973,12549636,855377,14266597,2022-10-31
3377e915904148b1,cc network,698456515,20504930,14012,2199,718977656,2022-10-31
34c73025e9445ac3,,21655,8773,0,0,30428,2022-10-31
1b52f2ff63328190,ting,1072141944,12999219,0,0,1085141163,2022-10-31
36035d18ec2fdcfc,mint,67331199,1724794,0,0,69055993,2022-10-31
8436dad2bc521297,verizon ,1759219119,117385549,2019023,317620,1878941311,2022-10-31
f889dabc14581cfa,mint,623496367,9225069,146194,45548,632913178,2022-10-31
dcd4d44e3338f174,mint,1679580066,49751171,244431,26871,1729602539,2022-10-31
ef62485e7ab30bd9,,123,620,0,0,743,2022-10-31
ec9f045126580d7b,mint,469627721,41016131,0,33,510643885,2022-10-31
911c8ef013a5ecd1,verizon ,248862067,35588760,513557,184901,285149285,2022-10-31
cf6b490637ec023f,,11357688,144632,0,0,11502320,2022-10-31
15529f3abb2ecd11,verizon ,0,0,36930,10261,47191,2022-10-31
11789a9202b210f2,verizon ,780656190,12709392,173841,19311,793558734,2022-10-31
e63a2aaa50a37a98,mint,582385225,41051089,1362072,317206,625115592,2022-10-31
7c4b25008e4154ca,mint,734321,266406,18930,6053,1025710,2022-10-31
e71b99340e2c1368,verizon ,986810176,52152817,15006,5830,1038983829,2022-10-31
bfcccd11000b87d8,verizon ,6297507142,158808820,6661,1793,6456324416,2022-10-31
3cb6301f36d152cc,mint,304970,146256,274771,104992,830989,2022-10-31
a0a9139e0f62a005,,1206435,279135,508447,151713,2145730,2022-10-31
c2f142ac8fa35a2f,t-mobile,798348999,71000969,0,0,869349968,2022-10-31
596925d2fa139847,verizon ,16989840,886630,16581133,371431,34829034,2022-10-31
2149b00d50996a85,mint,160661,45754,676575,231014,1114004,2022-10-31
01bba6b6a8f75777,mint,664227992,54359421,1785556,251572,720624541,2022-10-31
105b91a01822c439,,655360420,24104904,0,0,679465324,2022-10-31
dfb419f7fe854a19,mint,68387748,1617217,0,0,70004965,2022-10-31
21d576638429564c,mint,636666361,55869404,698117,69231,693303113,2022-10-31
a5ac5ca193dee1b2,,7418432,253824,0,0,7672256,2022-10-31
c24f71e1a9de6306,mint,685799076,30697343,119399,46981,716662799,2022-10-31
30ce0019266ffc8e,mint,918198785,29296113,1629426,407200,949531524,2022-10-31
e9e183a5af8cacdb,t-mobile,252092439,6931299,321601,255421,259600760,2022-10-31
0f0f652b3938f8c0,mint,821614,246214,411680,140652,1620160,2022-10-31
aca9d8474150931a,t-mobile,567162,175506,480530,171785,1394983,2022-10-31
6450f60741b34cfb,t-mobile,95641,142386,92683,36973,367683,2022-10-31
bb9f36d6851e4f8c,mint,293998,99070,37258632,876317,38528017,2022-10-31
b3a484e869f7be1c,t-mobile,0,0,869551,309748,1179299,2022-10-31
e1c444a432cbd9b1,t-mobile,74902811,1836567,33812288,1265983,111817649,2022-10-31
c349732d8713fab7,t-mobile,485556626,39216000,985203,167758,525925587,2022-10-31
d259bfae8a27c94a,metro by t-mobile,924842292,92238372,1778476,246449,1019105589,2022-10-31
19ea438b75a61a83,mint,21637,7796,44318536,1823964,46171933,2022-10-31
4aa713f3e7b5113b,mint,831902767,46347509,22765721,1726773,902742770,2022-10-31
c80a5209625973db,,42346,130150,9245,2352,184093,2022-10-31
6dc7f9c8bac733cd,at&t,729,13135,104161,40595,158620,2022-10-31
120fcc97c8cd2042,,1185950108,14415582,0,0,1200365690,2022-10-31
cba74b0a927c826f,,28491,76844,0,0,105335,2022-10-31
76431f20a8f080b8,t-mobile,3194294381,44862435,226,170,3239157212,2022-10-31
e954b93a678a5a90,ting,13759810173,229251764,0,1108,13989063045,2022-10-31
064f3b313bdf3ed1,mint,448003,36393,20797,4526,509719,2022-10-31
c016cf5073e1cf32,t-mobile,1007949220,50997737,526856,433040,1059906853,2022-10-31
9f9d2056fc21f431,mint,96050744,2900842,0,0,98951586,2022-10-31
b3b9a9f9e29966e7,t-mobile,689714161,36397852,653267,28797,726794077,2022-10-31
f95f33de3a1fd71f,mint,865684755,67291218,903580,128960,934008513,2022-10-31
7c52679c5878378e,,100556,1160789,0,0,1261345,2022-10-31
05241c265a6bfb48,,870031,283587,138624,363782,1656024,2022-10-31
14673d08bbbf9ed2,mint,745990037,54837730,6756,1961,800836484,2022-10-31
427d995253e0ce83,,150085218,2733384,0,0,152818602,2022-10-31
8a6bb241934decc0,t-mobile,2913013644,90979916,28248,15405,3004037213,2022-10-31
478a974e3a94db02,mint,1025213296,78697749,780369,94205,1104785619,2022-10-31
54f053b2e0bb69e6,mint,0,62,127664813,3169449,130834324,2022-10-31
d409f55f852e516b,,1522571,297307,198712,64123,2082713,2022-10-31
57a9a574396ef815,at&t,807387,269824,169834,51156,1298201,2022-10-31
0254a6846888732b,,35934,12422,0,0,48356,2022-10-31
16cad987285f7c4b,mint,507551294,7817829,24438,19120,515412681,2022-10-31
6ee6fa0ed24c6d67,mint,629770559,65471869,29300,11474,695283202,2022-10-31
db4e6261e49b0525,,1961820100,59977534,7207,3435,2021808276,2022-10-31
3056f88d2cfcd16b,mint,33418752327,796456000,12199750,1730961,34229139038,2022-10-31
88d3877d93c8d6da,,804673,257400,447260,165704,1675037,2022-10-31
516e8c03d029d525,,38717492,638955,0,0,39356447,2022-10-31
47f2f3d52d1f07f4,mint,578951,172201,0,0,751152,2022-10-31
2788292935ea29ef,,26627493,1579071,0,0,28206564,2022-10-31
7a8e7d24e2b646ef,t-mobile,479956276,48042812,498,911,528000497,2022-10-31
e0712a7f38413e17,mint,132279681,7033984,0,0,139313665,2022-10-31
0ed011b4a7ac1904,mint,1080503717,20227972,102880,36035,1100870604,2022-10-31
c40ba6ac033c5e8a,t-mobile,618283270,52952008,1299978,287430,672822686,2022-10-31
f17c37a77e280bae,,749684,215857,283788,82640,1331969,2022-10-31
f97ac580c6989583,,2743851695,6289820,0,0,2750141515,2022-10-31
11cb0b3d77d569b0,mint,83813246,3106642,29037,62728,87011653,2022-10-31
3c85a234b1a7377b,mint,1027487,270847,12472,5171,1315977,2022-10-31
0ae6df239683896e,mint,483578,156707,402143,122753,1165181,2022-10-31
9839f26be02a0f62,t-mobile,769801,651049,805688,290921,2517459,2022-10-31
1327a8b682dcd79c,,80352,18319,0,0,98671,2022-10-31
8c428f2bf9b67c01,mint,634277,160006,20513166,1437546,22744995,2022-10-31
e8f6aa0827be03e4,mint,213938,69845,805574,246840,1336197,2022-10-31
1711b7edc542047d,mint,169,82,745208,224655,970114,2022-10-31
e579c645c854ab02,t-mobile,574617542,7807510,127975037,9092966,719493055,2022-10-31
191ae8e68e2800d7,t-mobile,802508611,65281217,688545,48558,868526931,2022-10-31
e6647ba6585e8875,mint,736653935,33376792,51019,19198,770100944,2022-10-31
ac83585ace68e419,mint,540057418,44015888,576589,229197,584879092,2022-10-31
69f5da5dccfb9240,mint,160083,36251,0,0,196334,2022-10-31
9a49f426f388b6bd,,169696687,2340673,0,0,172037360,2022-10-31
003a079538ed0bb7,,2488598,892982,0,0,3381580,2022-10-31
569533e7316fdf14,,235543472,18668235,0,0,254211707,2022-10-31
8cae4b07eddbf46f,mint,2261225443,80770225,14277,2507,2342012452,2022-10-31
0091e571698ce4c3,t-mobile,1632079088,65577447,6141,1901,1697664577,2022-10-31
a7c182e41648e9aa,mint,1139662323,70549543,153097,50275,1210415238,2022-10-31
cb95893859e96818,mint,576794014,42796237,165395,74531,619830177,2022-10-31
eb96678c7bd6b032,t-mobile,1029372,216259,657862,107120,2010613,2022-10-31
9237af381a28df98,mint,85872724,3940783,0,0,89813507,2022-10-31
a2abf3b90a63842c,t-mobile,0,0,0,0,0,2022-10-31
077988e165099351,mint,320399992,21767238,0,0,342167230,2022-10-31
634b9bbf11bb07ca,t-mobile,449264116,39940086,1967892,317539,491489633,2022-10-31
b394b0da9cf303ba,mint,1851996,628754,0,0,2480750,2022-10-31
e8711b7447e5dfa7,mint,600492255,41668896,57941,21842,642240934,2022-10-31
b7595c8a2147dfc5,mint,2217760186,64172829,16,23,2281933054,2022-10-31
758362c06c594d7b,mint,410549630,37337563,75777,18638,447981608,2022-10-31
9bf6493a639640f2,,333482094,41284250,0,0,374766344,2022-10-31
560b1ca1dee865a0,mint,0,0,1426277,321251,1747528,2022-10-31
9a0dbf95517b4ce0,mint,1170144427,50954435,488,511,1221099861,2022-10-31
8953be03d98cd234,t-mobile,634169950,64809882,449547,99748,699529127,2022-10-31
9e712603559daa7d,mint,747767931,29393782,2414576,519793,780096082,2022-10-31
1e41713507e40aa7,,817171,272728,0,0,1089899,2022-10-31
6271bb5f803b676f,mint,83247205,9170291,944855,71392,93433743,2022-10-31
3e48572e8abd5919,,56658258,1046566,0,0,57704824,2022-10-31
f7ec20057da17399,red pocket,99730933,14059752,14113,8762,113813560,2022-10-31
fbadd1e890f8f956,mint,686024879,55893353,12292,2435,741932959,2022-10-31
f69a9b9ab6dd4015,mint,812119525,72558214,73639,26614,884777992,2022-10-31
5f363628787416d5,mint,834836539,36575025,1119612,232278,872763454,2022-10-31
d41892ab454c6c5f,mint,303037013,38424067,917433,248155,342626668,2022-10-31
b6218ec57eaf7e8f,t-mobile,3629808023,63629668,2008542,279456,3695725689,2022-10-31
719115d8669b21f3,at&t,781659462,72719762,164524,67802,854611550,2022-10-31
d92f8b9583154b51,at&t,579272916,58076072,297316,108965,637755269,2022-10-31
9b83acd0f5a6c23e,,939786,264482,635793,172142,2012203,2022-10-31
9135a4df637922dc,verizon ,989944487,74613412,0,0,1064557899,2022-10-31
57c86bb6e421de1c,verizon ,327199079,45089330,1405407,274005,373967821,2022-10-31
62af547f8a3aaa5b,verizon ,601900956,59984917,41382,12599,661939854,2022-10-31
f2a25b5c1be1cd15,,20506927,3013422,0,0,23520349,2022-10-31
d10cf1751d30e39e,mint,342735816,38820796,147569,49553,381753734,2022-10-31
41a030b7bcbce6e8,,291990983,4770829,0,0,296761812,2022-10-31
f2185f3e068ebbf9,t-mobile,0,0,0,0,0,2022-11-30
1b0b0b6a6a370706,t-mobile,0,0,0,0,0,2022-11-30
85e3178b368fed14,grameenphone,114364871,2652798,0,0,117017669,2022-11-30
3f6d0557e107c1be,t-mobile,76842622,1196655,325995,148050,78513322,2022-11-30
c8227714a84a4e36,home,0,0,0,0,0,2022-11-30
5abd42b369f0ab60,t-mobile,213288,54868,32316,8760,309232,2022-11-30
5e8fcbb7f1179761,Verizon ,27771909926,505704772,8341,4747,28277627786,2022-11-30
c2a4d723dca12767,verizon ,626124,574322,208077,55547,1464070,2022-11-30
49152f15fcfbb4d2,,449242316,22550619,0,0,471792935,2022-11-30
0a6979e4f2bc8b1f,,4627843174,56974845,0,0,4684818019,2022-11-30
9c707dea9968bc41,t-mobile,0,0,0,0,0,2022-11-30
79890dbd53ac18a3,,36969,131526,0,0,168495,2022-11-30
56e4f64ea0b8651f,t-mobile,0,0,0,0,0,2022-11-30
c0514d6e952050ce,,523408850,38362355,183753,11519,561966477,2022-11-30
ba126bb9dab142b0,,294401,182515,2365443,1688456,4530815,2022-11-30
3e13dbf1892a0d40,t-mobile,0,0,45054,188970,234024,2022-11-30
eeb2e41876664c9f,t-mobile,708096869,44122229,1215371,261994,753696463,2022-11-30
53d004d951f3f857,t-mobile,0,0,0,0,0,2022-11-30
11ef12ebd95ce380,t-mobile,535064885,10681118,20095432,378261,566219696,2022-11-30
fe15c3cf5435572f,t-mobile,34936719118,652745680,833155,100732,35590398685,2022-11-30
37e9e1c08b78533c,t-mobile,0,0,0,0,0,2022-11-30
2a69a5ba1cdd406f,,2725,6317,0,0,9042,2022-11-30
cc2729a348f2ce2c,,28353681267,470438167,50844,26658,28824196936,2022-11-30
f6a385d09f655fa7,t-mobile,5839597177,125424483,353965,86281,5965461906,2022-11-30
16a73c60b5558757,,546521,177211,705079,232475,1661286,2022-11-30
adcf4e63a45fc728,t-mobile,765822944,16411773,53633061,2579163,838446941,2022-11-30
0d9737b8d8dea7f1,t-mobile,131440569,9508944,157609,55000,141162122,2022-11-30
44ffb73a9e3b7099,,893988,278307,0,0,1172295,2022-11-30
4786127f2544ad19,,2201369473,87729432,19501,6123,2289124529,2022-11-30
8371190d9dd21ccf,t-mobile,34200839,1335929,570226,189563,36296557,2022-11-30
cf17b1b10d723006,,406001099,8220890,0,0,414221989,2022-11-30
43265bc5575052a2,,601958743,10907490,0,0,612866233,2022-11-30
4bf997cf7faf5ead,verizon ,8757203609,150745912,227129,119607,8908296257,2022-11-30
246ce55eb6c10a8c,mint,636449195,52113247,1141002,211029,689914473,2022-11-30
1eb4cf2b320265c2,t-mobile,78120,26590,1067014,405801,1577525,2022-11-30
aab7628f15c28300,,36979496,3632317,0,0,40611813,2022-11-30
d7ba3c6c50a302e4,t-mobile,0,0,0,0,0,2022-11-30
f11f4190e2b4f251,at&t,834653,236354,7592,1978,1080577,2022-11-30
9e7f786c7da1498e,t-mobile,0,0,0,0,0,2022-11-30
aa9d65642124993c,pure talk,803297,254806,0,0,1058103,2022-11-30
744d59155bb74790,t-mobile,260418,736299,11427,1954,1010098,2022-11-30
f6ce52053a2e54a0,verizon ,0,0,316321960,3357802,319679762,2022-11-30
34c8a212bfdef3bf,,190085,77909,0,0,267994,2022-11-30
60db4995f57eb25a,t-mobile,0,0,0,0,0,2022-11-30
472b4c9ab6a084ad,,1242855,224533,0,0,1467388,2022-11-30
3f71fdbf303da2e1,at&t,897573,345179,22566,7253,1272571,2022-11-30
cdc29c9596de5ca8,ting,0,0,0,0,0,2022-11-30
24df12fff2a29cc8,t-mobile,0,0,0,0,0,2022-11-30
9b12f77a46a32faf,verizon ,6707607627,169473615,797692,378926,6878257860,2022-11-30
f1236edf3a62a6aa,,837958612,18686479,0,0,856645091,2022-11-30
95326df0618f2d53,,230781386,33692643,0,0,264474029,2022-11-30
52193b4218e79db9,t-mobile,621259,188205,148670,58886,1017020,2022-11-30
cf0c7bc7e42635c2,t-mobile,333954952,6358627,0,0,340313579,2022-11-30
1e105d178f939284,gsma,857517,280203,0,0,1137720,2022-11-30
e45a52c0f284ec9d,t-mobile,1026539444,31538014,110779,41526,1058229763,2022-11-30
b1213f25cbcd7861,t-mobile,237610305,4554416,70731,693900,242929352,2022-11-30
f15176e0b02f4c51,t-mobile,365961038,8218257,1425169,331877,375936341,2022-11-30
eee994f436cfc013,verizon ,2943952878,53163729,0,0,2997116607,2022-11-30
9dd4f38fdf6e2312,,23922,7748,1087599,351953,1471222,2022-11-30
f6542813470462b5,t-mobile,410903760,42696582,15759,18510,453634611,2022-11-30
7d946db61024dcfd,,292265,450627,0,0,742892,2022-11-30
239e66f511747892,t-mobile,768751974,93887363,310203,160828,863110368,2022-11-30
c4bc3fd2b9efa005,t-mobile,617269746,51158304,1101749,162708,669692507,2022-11-30
a50e51210d8fe580,,372294456,42111426,36013,11653,414453548,2022-11-30
ecba7cc82a67a492,t-mobile,1567142603,66286614,1412732,231474,1635073423,2022-11-30
6d8233d222ddbfc1,,857553,442464,236863,139753,1676633,2022-11-30
bb7a6679cebc398c,,157292997,13569248,0,0,170862245,2022-11-30
8de3bedeaf26e6c8,t-mobile,791484,316100,54592,17327,1179503,2022-11-30
8321f2dbf7760bcb,,978111045,65110233,26389,8954,1043256621,2022-11-30
ebaa14d6a6c6a514,mint,1449271823,75559991,0,0,1524831814,2022-11-30
24746d1c0694661b,verizon ,0,0,707437,47763,755200,2022-11-30
b1bdf547d819f270,ting,4106578393,129662089,1044718,185585,4237470785,2022-11-30
63e83bed694d7bbf,at&t,2155795091,89770569,1023446,183303,2246772409,2022-11-30
9243fa77d24f2a01,t-mobile,1412652,247619,866219,120617,2647107,2022-11-30
fbf0cf4dda7bd564,,642823,225683,0,0,868506,2022-11-30
1164c7f4600dd491,cricket,7226332712,157542551,1871887,301186,7386048336,2022-11-30
908e18364140648a,cricket,0,0,31272046,1261600,32533646,2022-11-30
2d757a7e24c3dc00,verizon ,366804521,38896365,1605883,360031,407666800,2022-11-30
3a04ed8c5f25d9fa,verizon ,49854445,2212065,0,0,52066510,2022-11-30
3bc53361cb2aad19,mx telcel gsm,0,0,0,0,0,2022-11-30
0657d04a1a1b2765,,52556496,764076,144725720,2707269,200753561,2022-11-30
c6a616de74cd0418,at&t,10896852686,189663168,0,0,11086515854,2022-11-30
378993f3afd077df,,44081,116124,0,0,160205,2022-11-30
63c212f5c369eff1,at&t,889027,291072,503472,189484,1873055,2022-11-30
3ed55179e2b3692a,mint,780589,211419,273999,74509,1340516,2022-11-30
1d4838ff2d30e85c,,134708,32301,0,0,167009,2022-11-30
76b34a9c4d16ab9c,mint,836133,258009,67157,22632,1183931,2022-11-30
42045f5937d8a363,t-mobile,340632341,41222138,736576,53075,382644130,2022-11-30
f43b52ca118067e5,mint,3024858814,72299946,479435,138252,3097776447,2022-11-30
dd569c9213b48de4,verizon ,701813201,72095818,278860,96102,774283981,2022-11-30
15766ac562ae0004,verizon ,0,0,0,0,0,2022-11-30
fbc3954750663917,verizon ,952175,296997,328334,132313,1709819,2022-11-30
d63457c64f78db6d,t-mobile,288255985,22857589,36689,11418,311161681,2022-11-30
b3405d3f2b0ca091,verizon ,848869409,64615697,722916,58302,914266324,2022-11-30
f80398600d378cfc,,861259559,56977220,1541179,200136,919978094,2022-11-30
d7a078c002bfd131,t-mobile,803199387,26914829,96580,31574,830242370,2022-11-30
fa5560e0a98c645f,t-mobile,232548131,18621198,27325,8132,251204786,2022-11-30
480a352d8ed76a93,t-mobile,1458768312,37519828,1468406,40804,1497797350,2022-12-31
fb8fe8f221fd5fd0,,157971137,2076375,0,0,160047512,2022-12-31
9a9ac839ecd3a193,,157081693,2716996,0,0,159798689,2022-12-31
a99d7b2fe7a6fd6b,,158142037,1449820,0,0,159591857,2022-12-31
5f1690e4d7035370,t-mobile,1401931545,29993100,37168,16417,1431978230,2022-12-31
4bd2a578eb165422,t-mobile,2288705117,44789556,347,2121,2333497141,2022-12-31
97d92aae6bf312b1,at&t,852909661,53677769,1446605,42305,908076340,2022-12-31
213f8df9119b2256,metro by t-mobile,1534120028,28099240,736785,24414,1562980467,2022-12-31
5ed6827d17bbaf30,mint,363965708,11850329,1489090,178703,377483830,2022-12-31
bb37ee3fded06fdf,,158120410,2204243,0,0,160324653,2022-12-31
681d26a5b93888e2,ultra,4277429410,74573676,721948,25147,4352750181,2022-12-31
faaf6544e37fec90,tello,1205354719,59598868,1823,20500,1264975910,2022-12-31
ce22be461ec991da,ultra,6072414866,99737260,752693,25636,6172930455,2022-12-31
c9e2321f238338ec,,307432628,5691086,0,0,313123714,2022-12-31
8e1600e4b032c11b,at&t,1297491560,20560292,1805332,395461,1320252645,2022-12-31
f60ae7bd4c5a9fdf,verizon ,1370945700,40460134,35657,14639,1411456130,2022-12-31
40bcbb85a5b1094f,,270553015,3044520,0,0,273597535,2022-12-31
15c47a51275b452d,mint,663252192,53940653,55312,14673,717262830,2022-12-31
7b3ef3b64da18f24,verizon ,605811180,22750485,1653527,146865,630362057,2022-12-31
24a01c953a19a20d,,82933040,1686475,0,0,84619515,2022-12-31
8ac2389e1f52a8d4,,879098,254485,0,0,1133583,2022-12-31
944aa0f8c1fb5255,,30001,129973,635127,207467,1002568,2022-12-31
33ff0d666a03d082,,953200,269127,332931,104385,1659643,2022-12-31
7900046561463745,t-mobile,0,0,0,0,0,2022-12-31
3a2756243d6b5098,t-mobile,0,0,0,0,0,2022-12-31
b84328b2d83e9c98,t-mobile,1160128,449152,377564,171341,2158185,2022-12-31
288f5c243d626f32,t-mobile,1134839443,61042452,387,2737,1195885019,2022-12-31
13db8dbe5cf97507,,33251,7002,0,0,40253,2022-12-31
d57fe5a326bf9422,t-mobile,2712583464,50584916,1003779,219100,2764391259,2022-12-31
6ab035135b1f6199,t-mobile,936788,283483,550,8279,1229100,2022-12-31
61afc18e79f8bb6e,t-mobile,0,0,664766,264383,929149,2022-12-31
5ff2a499e2322b6a,cricket,0,0,44966866,1026594,45993460,2022-12-31
adb1f8de2c134df1,t-mobile,0,0,0,0,0,2022-12-31
ce58c01bfa235630,t-mobile,0,0,0,0,0,2022-12-31
e7c148d59ae3ae5b,t-mobile,35758790,708718,79228469,2823522,118519499,2022-12-31
9df3e493bb13c996,t-mobile,0,0,0,0,0,2022-12-31
ad045e091f824e16,t-mobile,749232,229438,796024,279292,2053986,2022-12-31
cdf143b16e61e5eb,,1479581024,25153167,0,0,1504734191,2022-12-31
5c062c05500f1177,,151922497,4487402,0,0,156409899,2022-12-31
b4284693e6ec13c0,,16645297,1286506,0,0,17931803,2022-12-31
4098b46752e419cb,t-mobile,0,0,0,0,0,2022-12-31
a129145049aa6129,t-mobile,0,0,0,0,0,2022-12-31
d3f2ebe8e517fbf1,t-mobile,904201,559734,143002,54920,1661857,2022-12-31
8230264a73a54eba,t-mobile,0,0,0,0,0,2022-12-31
82ba6cf8024bf3a4,t-mobile,499258069,11073127,1938,13388,510346522,2022-12-31
bfa21df6a55e79c7,,918571,351197,55767,22187,1347722,2022-12-31
1e08c60e1be47d22,t-mobile,94373,49095,296195,119980,559643,2022-12-31
e5e865619185083a,t-mobile,430249,120288,929557,297685,1777779,2022-12-31
9318212a3cedc3e3,t-mobile,0,0,0,0,0,2022-12-31
06b906fc1db0607a,,447127,121333,0,0,568460,2022-12-31
54ee02d386ff1d24,verizon ,4984648316,86284033,831259,74535,5071838143,2022-12-31
7c64b203ee1214b2,verizon ,32763,25720,721744,340606,1120833,2022-12-31
308bb77fd46ac6ec,at&t,0,0,831726,247054,1078780,2022-12-31
ca0cad5f05300ee1,,1373431,315228,0,0,1688659,2022-12-31
117f8356afc10f39,verizon wireless,0,0,0,0,0,2022-12-31
a7c828368cf8d613,,781075,215166,14952,125734,1136927,2022-12-31
cfe740bccc43282c,at&t,0,0,0,0,0,2022-12-31
77d17c0430c45652,t-mobile,1009260648,60653820,0,0,1069914468,2022-12-31
e6f6414dc3ebca0c,,38765576,1030452,0,0,39796028,2022-12-31
ca97f644264a7840,,14518980680,361457798,0,0,14880438478,2022-12-31
c6652343e6491567,,78036820,1893903,0,0,79930723,2022-12-31
6c1d403054ce46ad,,1785471,431815,0,0,2217286,2022-12-31
9c802ba0da34b835,t-mobile,1257588126,57937008,1444351,45442,1317014927,2022-12-31
1e9a793f9d1c042a,t-mobile,675944902,40749518,12269,2413,716709102,2022-12-31
ff54869253be30a3,,38815427,1726486,257682,76012,40875607,2022-12-31
2f53a6df6c2be017,,2661717093,47104078,0,0,2708821171,2022-12-31
ecd2ab6f09c7abac,,66654857,2119509,0,0,68774366,2022-12-31
e53c276591ceef0b,t-mobile,881882,297867,339536,134288,1653573,2022-12-31
cf3abcdc75d513bb,t-mobile,831862,292598,30642,10357,1165459,2022-12-31
aa0efbfb2866b8f0,verizon ,13736779,444115,13995122,490575,28666591,2022-12-31
0fc37ae3ba41d760,mint,0,0,0,0,0,2022-12-31
cfdb8d8c5e8e08ae,verizon wireless,230102927,5873549,3645048,328283,239949807,2022-12-31
850e00f6699d0797,,456841876,13053316,0,0,469895192,2022-12-31
1e19fb2b9d3a7c09,t-mobile,446385290,42679792,0,0,489065082,2022-12-31
9d0120d83b2722b8,t-mobile,0,0,0,0,0,2022-12-31
e2aa9e5af47a558d,verizon ,0,0,178088215,4901014,182989229,2022-12-31
df436676fcae6669,home,1278281158,72893923,0,0,1351175081,2022-12-31
d4371424687cf6f0,,91095846,2182423,0,0,93278269,2022-12-31
67afa5223f6fe711,mint,784835757,60306855,18037,14320,845174969,2022-12-31
65845643cdb67450,t-mobile,255076824,12212465,1803018,228178,269320485,2022-12-31
c805d192dcd29aae,t-mobile,820311,274428,0,0,1094739,2022-12-31
aa8802f7e8edefc5,metro by t-mobile,6020685160,124434745,14692,3584,6145138181,2022-12-31
601f3e496168dbdf,t-mobile,0,0,629229,394579,1023808,2022-12-31
92f91f85d3593fdc,mint,924380,295310,0,0,1219690,2022-12-31
1fdc44e6ac200f4d,t-mobile,1482749,264418,398855,37888,2183910,2022-12-31
90cc3e5ae14d8a62,t-mobile,817291,240597,473935,125834,1657657,2022-12-31
bfacb903ac8ba329,verizon ,631622911,45723287,16397,11656,677374251,2022-12-31
ac22a0fc3d9080b7,verizon ,3045399938,112195047,104532,36817,3157736334,2022-12-31
c106d864325da489,t-mobile,108579627,1850944,0,0,110430571,2022-12-31
c80a9e09f898039a,mint,5219324338,131292634,7561,5841,5350630374,2022-12-31
0db3c0f6e72dc70e,t-mobile,735642,217168,7785,2199,962794,2022-12-31
7ea7a024f2cc9d5e,,11702252939,258105381,528653,191796,11961078769,2022-12-31
eb8c8faab311af0d,mint,29321337,2259055,141,1074,31581607,2022-12-31
80b6e8c2216cc2ff,t-mobile,520459862,59923457,0,0,580383319,2022-12-31
ad9b7c3e0b4e346d,t-mobile,28414828,6030950,0,0,34445778,2022-12-31
d5109ff299c71c49,mint,49890149,2264812,6493,1679,52163133,2022-12-31
4fdadf523a1ebd86,at&t,134326,39415,133399815,2371982,135945538,2022-12-31
c8f26c9b16fa2bfe,at&t,925633,327190,610358,210386,2073567,2022-12-31
7af2a642e435e268,verizon,848385,241477,0,0,1089862,2022-12-31
f43bc61443c423b4,mint,2230665820,75133694,1171765,237158,2307208437,2022-11-30
fd12af2faae41341,verizon ,0,0,3152385,64440,3216825,2022-11-30
b9d385b5b473e8ea,,642849,303876,7263,2295,956283,2022-11-30
f99a62ea272419d6,mint,0,0,1394413,100698,1495111,2022-11-30
414e6a14c395ab8d,mint,698263,226596,310981,104004,1339844,2022-11-30
c326874ee702f0d6,t-mobile,46283,12118,45009,14499,117909,2022-11-30
7f49927cbf3348b6,verizon ,988333100,21669110,120,6630,1010008960,2022-11-30
c47c1d978ea5c8aa,mint,0,0,31564,11324,42888,2022-11-30
84b782727c692dae,t-mobile,800112510,105983294,6853,2271,906104928,2022-11-30
a94d8b4c505aea95,t-mobile,768771989,71184928,729851,163618,840850386,2022-11-30
afbfa9a7bcc3dcb5,mint,486551600,6820468,18614630,798190,512784888,2022-11-30
fef23fabbf226604,verizon ,767355,234390,93560,38171,1133476,2022-11-30
6bfd3352e6073bbe,t-mobile,863302,289580,0,0,1152882,2022-11-30
9350023f5f13e539,mint,206229535,36051481,65478,23063,242369557,2022-11-30
8854eef09c0d2b7d,mint,8740,1970,0,0,10710,2022-11-30
098756127c54e530,Verizon ,0,0,817077,295775,1112852,2022-11-30
2587aac236fd4731,verizon ,756773,288495,321065,137198,1503531,2022-11-30
d5080cfb4f62ffe9,,810100,281285,104,104,1091593,2022-11-30
ce3c62c4b63b2cb0,red pocket,886504679,50119214,914451,119157,937657501,2022-11-30
d0d96132f00ae671,,729611,270573,334106,120937,1455227,2022-11-30
9d211ad7fc88560c,mint,0,0,16789284,723394,17512678,2022-11-30
9e3f375d9d4ccd15,,178186702,2413376,0,0,180600078,2022-11-30
3baf3441461f2e96,,757393,195866,207826,75082,1236167,2022-11-30
49f7cfb62a725d97,,762981,219960,30757,9380,1023078,2022-11-30
1a0bec8534827828,verizon ,336762585,8329485,795907,342537,346230514,2022-11-30
821a9aa4b60407fb,t-mobile,15613,3450,0,0,19063,2022-11-30
aca408d50678a162,mint,151885043,2071104,218,4357,153960722,2022-11-30
3f2429f0de564bf2,verizon ,6635036580,112849925,857680,97661,6748841846,2022-11-30
9fce2109ee9e324a,mint,799875538,43176732,27885,10400,843090555,2022-11-30
6d5e1364ef670db2,t-mobile,608058,197548,111459,35988,953053,2022-11-30
621593aeb29ce5ab,t-mobile,4101365506,112416423,672952,30271,4214485152,2022-11-30
b749b4270479aa7d,mint,33742,129344,13890,153295,330271,2022-11-30
6226bb346086aa79,verizon ,376545967,50500130,138062,58867,427243026,2022-11-30
814a2e366ed0ac13,t-mobile,1428392695,15385268,141105,58665,1443977733,2022-11-30
d31925917c00852e,t-mobile,872043,219804,63091,23665,1178603,2022-11-30
9953a5c92a80cfdc,t-mobile,1387470656,87002462,0,0,1474473118,2022-11-30
09889d0a6b091da6,mint,432524,157015,295770,91503,976812,2022-11-30
d08b4a302bf8d000,700 mhz public safety broadband,229864909,3145046,75345883,1860266,310216104,2022-11-30
203635a3fbe58277,t-mobile,20761203,840535,424746,43684,22070168,2022-11-30
eb7824ca35551262,,19985766,1275766,26933,9197,21297662,2022-11-30
01d7c6ee5d3136a8,,19983052,1317261,692,2540,21303545,2022-11-30
819d825e8bbeca46,t-mobile,753000798,17018577,64646,18044,770102065,2022-11-30
1e7ed7f2c9597777,mint,883578,257572,15215,3806,1160171,2022-11-30
aa1b18fd8b7312a4,mint,639106,192309,1497173,585848,2914436,2022-11-30
7b0279778f82b2af,t-mobile,204456917,10589181,52248,22386,215120732,2022-11-30
95a86b831d0c41ae,t-mobile,338309,122896,893726,347337,1702268,2022-11-30
e6af9bf55eee2f92,mint,898645,259334,195848,55531,1409358,2022-11-30
39f443b482f8dbda,verizon ,675137368,57420353,22301,19747,732599769,2022-11-30
3932329c113d0e5f,,43101444,826910,3234033,62482,47224869,2022-11-30
b1b8a28d448d0bf6,mint,608645260,45165545,13513,4770,653829088,2022-11-30
0dbbb8fc247cb28e,t-mobile,326502110,18341714,6853,2199,344852876,2022-11-30
160a628d1cff8e4e,mint,314839199,22279811,385800,17755,337522565,2022-11-30
05b03175c91f9b74,mint,989416201,53840477,433170,154772,1043844620,2022-11-30
15d4cbf9ff7a1b8b,verizon ,431429313,52592274,64709,28819,484115115,2022-11-30
fcadf61438b8fb73,,49816791,987670,0,0,50804461,2022-11-30
db143ffc74904eae,,261862489,18674759,1539792,583360,282660400,2022-11-30
a29308ee7e82fc4a,mint,0,0,617826,181776,799602,2022-11-30
9164bf1e3bbbe4eb,t-mobile,636944666,61909805,0,0,698854471,2022-11-30
0efbf74933c9ad68,t-mobile,1001844300,59818513,129373,57396,1061849582,2022-11-30
97e9d53cecd70f46,mint,26478,12056,0,0,38534,2022-11-30
bb4611588b39d10f,ting,568521231,12190864,0,0,580712095,2022-11-30
6626b43eac379d21,t-mobile,813595763,67888673,84,84,881484604,2022-11-30
2a77137bb98fb9f9,t-mobile,309431159,15311389,0,0,324742548,2022-11-30
b5f7820f99d4c9b8,,663264398,6934934,239250,608240,671046822,2022-11-30
b277e405fb11bf21,mint,972245714,84584689,718893,154128,1057703424,2022-11-30
52061e44719fa6cf,mint,0,0,18092861,627909,18720770,2022-11-30
90e67a02ee1daabc,t-mobile,248458,68913,74186,8074,399631,2022-11-30
ffdae9e955b9fad6,,60682135,972630,23055002,853453,85563220,2022-11-30
1939560d20dfcd27,t-mobile,305088675,10791161,0,0,315879836,2022-11-30
ebe6290297546a5d,mint,0,0,0,0,0,2022-11-30
7fa51eadbb907375,t-mobile,2422964541,92332081,0,0,2515296622,2022-11-30
8cecf314dd30854c,,228612025,22040908,0,0,250652933,2022-11-30
ee601f458bbeb39d,,83592274,7076286,0,0,90668560,2022-11-30
8613788f691805f6,,35212568,1097221,0,0,36309789,2022-11-30
dd01b0fbab51c568,mint,124257938,1066118,15765,5637,125345458,2022-11-30
6742bda988ae6b7e,t-mobile,623482772,54845664,8375,61805,678398616,2022-11-30
98b4c0721fa5193d,t-mobile,830545638,70812450,0,552,901358640,2022-11-30
8d0858ef90da09a3,mint,51673638,857072,1206,19248,52551164,2022-11-30
6b0a750ff07ba8f9,t-mobile,618535013,10200687,0,0,628735700,2022-11-30
68edb3ab27349de3,t-mobile,32220749,898587,0,0,33119336,2022-11-30
4d4556c218b44307,t-mobile,197423,397864,0,0,595287,2022-11-30
8107c1acd4b3dae1,t-mobile,947806265,43267595,1923511,279485,993276856,2022-11-30
754dc503863763a7,mint,836214,247458,50765,19090,1153527,2022-11-30
a5cb2611e23a6171,,73581245,1514856,0,0,75096101,2022-11-30
71d5d3b715fd7e39,mint,796446,272661,0,0,1069107,2022-11-30
8782b8eefba7c92e,t-mobile,937592721,35196132,0,0,972788853,2022-11-30
0d4e65ea177a5c1d,mint,641746851,59994667,544943,48450,702334911,2022-11-30
ac0495cd99fa5e65,t-mobile,772574296,75299331,0,0,847873627,2022-11-30
35ac7628bc704470,mint,715301332,40159362,0,0,755460694,2022-11-30
70c885f4ab7ff04f,mint,484370,152513,90257,27395,754535,2022-11-30
050ca259bb2b6fdc,,2581186017,44361984,0,0,2625548001,2022-11-30
5b72e69888a71914,t-mobile,634737,182332,0,0,817069,2022-11-30
acf552ee295b60ab,mint,591239620,17751661,0,0,608991281,2022-11-30
6066827ac162066c,,329939330,25761149,959838,172185,356832502,2022-11-30
2c127eda7f012606,,22144,8924,0,0,31068,2022-11-30
2cb02d98eb582d38,,1031033824,29517233,0,0,1060551057,2022-11-30
c6f6327d014e7ad5,t-mobile,177658,49042,16241,4032,246973,2022-11-30
febb14a9553945c4,,410457841,5087190,0,0,415545031,2022-11-30
b3b9379a98158c0d,t-mobile,2549063498,63995015,1925722,336691,2615320926,2022-11-30
440122e817af203b,,73509721,1099593,0,0,74609314,2022-11-30
541898933a28f72a,verizon ,683069792,49981982,730519,27374,733809667,2022-12-31
8a3b14121cfee49d,verizon ,2931507025,127861123,742926,41753,3060152827,2022-12-31
2fff72936e07f89f,verizon ,219879527,20614470,2154160,291008,242939165,2022-12-31
117de93084fc9be7,,116583311,4943251,0,0,121526562,2022-12-31
90e8608b08c284f7,,870954,239021,98330,19935,1228240,2022-12-31
65e227ac558b5594,verizon ,1017058468,73654342,29163,13523,1090755496,2022-12-31
574dcfef4558f162,,783480,272335,0,0,1055815,2022-12-31
7f5971943e3c8980,mint,1493361,153558,438377,198418,2283714,2022-12-31
b4f12ca616be0dfb,t-mobile,776333811,31002124,7081,2368,807345384,2022-12-31
b199956e0e42d790,verizon ,76783866,1845644,770162,308086,79707758,2022-12-31
32a0b28a6c46875a,mint,32627080,355205,66437395,1202235,100621915,2022-12-31
41c76efc37883c7b,mint,508481480,35602687,25405,13182,544122754,2022-12-31
dc6f967bc13989b0,extended network,40287694,735501,0,0,41023195,2022-12-31
e2d3d3f1001edb12,,730328,244895,8763,3388,987374,2022-12-31
4281add1d84ab8ba,verizon ,4365433067,89704909,6713,2004,4455146693,2022-12-31
4681aee8e79891c6,,814848,244865,14774,3674,1078161,2022-12-31
f11e4c6e2f47a44e,t-mobile,6210,7026,141412554,3275145,144700935,2022-12-31
a1fa57195fc8f4c7,at&t,234095922,3678933,47520,12737,0,2022-12-31
2b86cbb5ff8acb33,verizon ,524107279,34337969,0,235,558445483,2022-12-31
c9e9297c3e49880d,verizon ,322253753,19840606,1442650,73860,343610869,2022-12-31
26acd5ffe16e738a,t-mobile,1185951075,72777742,23849,14234,1258766900,2022-12-31
a4b716fa8e19c93f,mint,221594,176563,23830,7821,429808,2022-12-31
859061fe0022d00b,t-mobile,913303384,61092002,34338,7650,974437374,2022-12-31
3777583fa623c814,mint,28731,21105,956981,227084,1233901,2022-12-31
1df7ae16fb97e7c2,,162180110,8060694,0,0,170240804,2022-12-31
45977eb02db91420,mint,40366840,170828,332,2436,40540436,2022-12-31
8ad40f5169014a9b,t-mobile,763347460,67061719,20748,5358,830435285,2022-12-31
0b7418873af83d1c,mint,221260716,31203895,32146,11741,252508498,2022-12-31
91de3d1006a10e27,verizon ,0,0,0,0,0,2022-12-31
b40d7717095d99fd,mint,222925880,5227337,0,0,228153217,2022-12-31
1a440a88258c7d43,mint,175947,92728,118863243,3526460,122658378,2022-12-31
d1b52e4301984c3b,verizon ,703379083,68684689,2159842,270468,774494082,2022-12-31
7ad31d267fd2f580,home,785670502,64045229,6565,1876,849724172,2022-12-31
15f2113f686cd91b,,265454528,4081072,153587,273450,269962637,2022-12-31
6ee5e626ec1b7718,at&t,77549711,1471699,268722,90075,79380207,2022-12-31
d0179af1938117ca,verizon ,5001578385,137693867,181601,35891,5139489744,2022-12-31
ab1f63d7c6128779,,39767355,1024503,0,0,40791858,2022-12-31
4b4f95c11d7c89bc,,53041751,663753,0,0,53705504,2022-12-31
1fd3dd898d4ab2aa,t-mobile,584176,184855,14950,3806,787787,2022-12-31
009801f524b6664b,mint,119263912,7423581,33511,8154,126729158,2022-12-31
44ae76445fbff091,t-mobile,849868,254833,229370,57177,1391248,2022-12-31
f9289fdd2a8fa1b6,mint,42774,132654,692,2264,178384,2022-12-31
8a4bed8eb960401b,mint,664970327,52277509,1688,2139,717251663,2022-12-31
1ba41d525df1192a,mint,276037440,4325090,203083,75447,280641060,2022-12-31
1257001bc3990433,t-mobile,432939179,19592997,294691,17182,452844049,2022-12-31
cc6e0f7cd02d65a1,,711876,184915,15273,4278,916342,2022-12-31
d5c1d3e6fa326949,,703804,205877,119244,42559,1071484,2022-12-31
fe2eb864618e7846,t-mobile,0,0,1465523,76876,1542399,2022-12-31
f935629799de5ccd,t-mobile,683032,261344,311023,115209,1370608,2022-12-31
464bd31d5ad531a5,mint,470137306,6169659,0,0,476306965,2022-12-31
54ae811928cd97cb,t-mobile,624730031,51258023,1612810,336250,677937114,2022-12-31
6f60f95a0da14fba,mint,833511,221202,230199,84695,1369607,2022-12-31
4a39f68d528fcca7,t-mobile,1447232583,45618143,44024,17136,1492911886,2022-12-31
fc34245e0593b21c,mint,679053740,35544255,172750,66988,714837733,2022-12-31
6352ade93c01e13e,mint,76064,31295,92913,11340,211612,2022-12-31
9d679b4a1834d988,mint,1237384974,69003977,1441353,65833,1307896137,2022-12-31
37456cd0ddbeeeb3,t-mobile,1080570452,96337942,166020,63888,1177138302,2022-12-31
83fa565402009967,,222234370,4288047,0,0,226522417,2022-12-31
9870ada253930da2,mint,475351163,37823925,12597,3678,513191363,2022-12-31
5a7911d3fdf88c74,mint,878333,417217,368701,136662,1800913,2022-12-31
90812a6d947e5eac,mint,541077057,10030579,0,0,551107636,2022-12-31
256fc14dda0071bf,t-mobile,303492,87149,302470,116511,809622,2022-12-31
889f28519fd610f9,mint,250283,94672,22896,221375,589226,2022-12-31
a7b61ca844e3c171,ting,935940,270050,76735,12101,1294826,2022-12-31
fa2f65511d704a63,mint,372794329,17704364,2072,15147,390515912,2022-12-31
ed417a78b37e5353,t-mobile,835262511,13676587,756140,35516,849730754,2022-12-31
63a38c2586b37bd7,mint,724249,179088,8967,2248,914552,2022-12-31
9e231593cf323ae5,,13848095,379245,16320,4032,14247692,2022-12-31
355d85fca81883c4,,168066242,3000417,0,0,171066659,2022-12-31
5b6273523ed2c405,t-mobile,0,0,21886,8521,30407,2022-12-31
f640789f1041a0f6,mint,867112063,74710035,6534,1701,941830333,2022-12-31
17c1b974672e0a6b,mint,333949578,6170806,104,104,340120592,2022-12-31
1a3ad9fbe79612b1,mint,134174925,2104568,9188,2352,136291033,2022-12-31
0bf7a917ab4fc295,t-mobile,898657314,55999482,28872,13849,954699517,2022-12-31
8b63d83ebe6d5fad,mint,661469,182784,297968,93789,1236010,2022-12-31
9866777fcad7b39c,,742150390,38454430,873199,152882,781630901,2022-12-31
98611e3f7cb5ee12,,175308385,2504517,0,0,177812902,2022-12-31
636be645bbe68060,,52473541,1778618,0,0,54252159,2022-12-31
cd0a9557ec35a9d1,t-mobile,520276,474152,114,82,994624,2022-12-31
a9baee366b3852cc,t-mobile,2192727,236603,0,0,2429330,2022-12-31
4df938d281b032b4,mint,152742,156500,0,0,309242,2022-12-31
c71ebe5d6707d2a2,at&t,45378409,6412562,35679,7669,51834319,2022-12-31
fe84586c4336888e,t-mobile,70706961,1647923,105069179,3301218,180725281,2022-12-31
c550ed088fc6cd6f,,876494389,52867525,293824,120487,929776225,2022-12-31
0904e21d52163999,,1134581421,101148435,1732154,280075,1237742085,2022-12-31
5bc0f547e9a97cb9,,24397787,794777,84,84,25192732,2022-12-31
505478687e369772,at&t,0,0,594251,240538,834789,2022-12-31
38aa7c4dc95c12c6,,1035682226,78057910,759433,36144,1114535713,2022-12-31
c879f614dc47c2b7,mint,711201,69264,0,0,780465,2022-12-31
7d515919346f7951,mint,0,260,467750,140527,608537,2022-12-31
e8e18bb6e3ad3bcb,mint,250035602,4878315,0,0,254913917,2022-12-31
b4bddb7e6abf9b6f,mint,434832682,36944014,104,104,471776904,2022-12-31
77336925b9f400fd,t-mobile,897892,263049,57585,25612,1244138,2022-12-31
e318bb75969ed4e0,mint,328580806,4643945,43798918,751895,377775564,2022-12-31
ff2895786fdc3a9c,,992758616,111899325,13833,4150,1104675924,2022-12-31
93d41f5a2f8d9095,,108250980,2731842,0,0,110982822,2022-12-31
7bf99d1343d137e8,,1051323585,63719181,295680,28348,1115366794,2022-12-31
b61eb9b373a46027,,148185766,2415112,0,0,150600878,2022-12-31
83db66f9e70219ca,,184041341,22679554,1590919,376698,208688512,2022-12-31
7d76b545cf27b75b,mint,264967,240530,55396,19323,580216,2022-12-31
222e939197fb2bef,,73528465,1404294,0,0,74932759,2022-12-31
054a46ad6cc14714,,675696129,13413076,0,0,689109205,2022-12-31
858c7e3ed2b2ebce,mint,242365333,24521043,0,0,266886376,2022-12-31
730eb0f3dca4d077,mint,836156235,62304452,3183540,636195,902280422,2022-12-31
7fd7b829a7e7ce23,t-mobile,618682,134032,0,0,752714,2022-12-31
156e4f360ff8420a,t-mobile,152646831,3078022,0,0,155724853,2022-12-31
e06b94120f8f054a,mint,771025,217242,484456,142876,1615599,2022-12-31
38b3562c0a54d7e8,,74568978,1727590,0,0,76296568,2022-12-31
cf9f8e90aacee587,at&t,1455488187,76842024,856171,81516,1533267898,2022-12-31
5aff4a08455d57fa,mint,220064311,6994780,1191001,192178,228442270,2022-12-31
68f49c4839ea4944,mint,183763,66839,5612,63242,319456,2022-12-31
7db09ec67549b53d,,227491,76051,28252,78763,410557,2022-12-31
5e6d6dcb4b5c5deb,mint,77004999,1361651,0,0,78366650,2022-12-31
50dd18a3f2f227cf,mint,196595492,3808680,74393,23497,200502062,2022-12-31
415c6c260fe07d9b,,523740030,28366256,48543,27295,552182124,2022-12-31
a3c67d9b43340869,t-mobile,4814,1168,20141472,1449430,21596884,2022-12-31
da192a7bd9b1aedc,mint,448423,134735,7599,2117,592874,2022-12-31
8effa41a7ca652f8,mint,200673511,6185690,0,0,206859201,2022-12-31
2b96d5eac830b71d,,871432,255035,185288,57782,1369537,2022-12-31
e5050008da723080,home,526079534,13828922,2504602,298621,542711679,2022-12-31
e1fa5995a0d04198,,73504648,1141047,0,0,74645695,2022-12-31
38cfb5604cd8e50c,t-mobile,21062017,570474,56190,27000,21715681,2022-12-31
bb1747a6e279dc97,mint,776924,214032,129753,58440,1179149,2022-12-31
0f5746926c93ef28,,12638,3697,0,0,16335,2022-12-31
6a35729f5cd3b830,pure talk,0,0,25339,14352,39691,2022-12-31
37ad2e782253c044,t-mobile,687297142,58708574,1426496,53842,747486054,2022-12-31
b7fa31a8671e44e5,mint,790350574,65297611,1474118,97697,857220000,2022-12-31
a3452bbb8d34bdba,mint,862424011,57288021,7044,2428,919721504,2022-12-31
f4cb16dc7016b704,,12615965,2764938,140390,50750,15572043,2022-12-31
e0a61742b435d99c,mint,905157467,70978996,25220,16912,976178595,2022-12-31
c2c83745392cc635,mint,21835000,3163336,31764,7702,25037802,2022-12-31
ed2d15b129ae261e,,236179968,2910287,0,0,239090255,2022-12-31
558cd4df40a51c43,mint,1040062988,80364801,0,0,1120427789,2022-12-31
97ab7e3bc5db7a0e,mint,1220893139,84438617,885000,166771,1306383527,2022-12-31
eca4c3ed74eeecd3,mint,537903299,54086023,0,85,591989407,2022-12-31
d5b306e1ea161f40,t-mobile,261993746,35124788,1465101,79127,298662762,2022-12-31
61688cb51aaadccd,,197421788,4185414,0,0,201607202,2022-12-31
ee2a32081b0e4b63,t-mobile,656889496,44252345,22085,6937,701170863,2022-12-31
95138b45d0852e06,mint,0,0,1082147,80259,1162406,2022-12-31
a7df0bf41ee1155a,verizon ,1047421802,67093832,765371,26800,1115307805,2022-12-31
1ebb961e106ff06c,verizon ,0,0,1036083,330039,1366122,2022-12-31
1b6a61c8517ac711,mint,2070168587,95429817,1509932,39207,2167147543,2022-12-31
b324f3fb2c16af7d,verizon ,1342795451,89375696,719213,21624,1432911984,2022-12-31
bd80624f5c51700f,,407936187,20875864,148710281,3143624,580665956,2022-12-31
cb95985cf3dfa6f3,verizon ,866968608,73866920,0,0,940835528,2022-12-31
895e93ff726487e2,,1334759260,87414350,28374,9404,1422211388,2022-12-31
af07489b03f5dbcf,verizon ,995223259,82742511,36366,15669,1078017805,2022-12-31
50089bc43f8ab1f5,verizon ,703022113,65645787,718300,22673,769408873,2022-12-31
022b4b02491cfe5f,mint,136440193,12769169,856399,120646,150186407,2022-12-31
2f27d9aa95a09fc5,mint,116862,1122242,7308,1688,1248100,2022-12-31
262fbcf4505e4f63,,0,211,1008513,304188,1312912,2022-12-31
55f985c7b7a2ef9c,mint,270863899,16636545,0,0,287500444,2022-12-31
e602a8f8ec7328e4,t-mobile,28811,12648,0,0,41459,2022-12-31
bac59757fd0773a8,t-mobile,788763360,73136608,116249,34236,862050453,2022-12-31
2055be453479fd0d,t-mobile,35546,8944,0,0,44490,2022-12-31
14b0b96b1cea3ae0,mint,167741380,2418113,239320,94104,170492917,2022-12-31
06951f1ce2fdb49e,at&t,428567238,43387681,21477,7214,471983610,2022-12-31
9d5c4f1120fd9abf,mint,843239506,46061541,160159,54762,889515968,2022-12-31
5d57ba68c04d0fb1,t-mobile,329651,89248,640241,205389,1264529,2022-12-31
2d9b48596b191a5c,mint,919143064,72443913,1531517,88892,993207386,2022-12-31
04fe1a977f37dd70,mint,483126030,27285016,1191527,198504,511801077,2022-12-31
1b1423d8b0dc20dc,mint,180549815,12063722,0,85,192613622,2022-12-31
9cacc7e21c866b28,,3204854534,35186245,0,0,3240040779,2022-12-31
3f55c7b308a3554b,mint,1208851168,39272011,0,0,1248123179,2022-12-31
85c968aa496bfc8c,,817914,234605,0,0,1052519,2022-12-31
da669a0e007e5829,mint,1339442330,85569963,6118,1384,1425019795,2022-12-31
1710c4c0cfd50e34,at&t,0,0,1832,916,2748,2022-12-31
679182998e8efe17,patriot,0,0,175503,42185,217688,2022-12-31
a387824eb9db94b5,at&t,1042901425,61145723,0,0,1104047148,2022-12-31
1fec4f9112002ec4,cricket,179213016,13946733,2570609,1036876,196767234,2022-12-31
0af87e5110d5dcf8,verizon ,1259679721,83484922,803087,48940,1344016670,2022-12-31
0b3ebaf9973d730d,verizon ,889468720,77873757,1151280,101910,968595667,2022-12-31
0e5dc80a72e5b684,verizon ,1099652568,67274401,726065,16960,1167669994,2022-12-31
4c286c0665347b95,,496934,58969,1361935,246225,2164063,2022-12-31
39a5cdae71de7030,xfinity mobile,732072624,78856897,922423,85634,811937578,2022-12-31
977f68569d9863af,verizon ,0,0,38611,9491,48102,2022-12-31
29c7a7e529a67b70,at&t,778763805,72382527,1668141,167473,852981946,2022-12-31
8a52a674c67817ac,,759288,187467,0,0,946755,2022-12-31
153103359fe74d9e,at&t,942581238,55323492,1483731,50564,999439025,2022-12-31
6c3cf3c350b32b8c,,18854125,375449,0,0,19229574,2022-12-31
2e9fe8d8e04a4a5c,verizon ,885596963,61615117,1471691,50586,948734357,2022-12-31
b51536d44cfc09f8,verizon ,989586735,44418617,948353,185284,1035138989,2022-12-31
462cb4a13896a54c,verizon ,440679944,46518921,1451680,46537,488697082,2022-12-31
0e7fed82f80c6f10,mint,747605656,56161059,1205240,73318,805045273,2022-12-31
fc7559c9151edf4c,verizon ,563640651,59740883,1439317,20735,624841586,2022-12-31
13d4d66884cc71a4,at&t,2368754814,40793883,2286521,383441,2412218659,2022-12-31
ed45615b41cc5beb,verizon ,1531150793,81624593,35894,13133,1612824413,2022-12-31
94959c5c08a436c5,,168222282,2161867,0,0,170384149,2022-12-31
0d6c8940039b34c8,verizon ,986802935,71531592,1150019,179349,1059663895,2022-12-31
998a9ad8288f841c,at&t,71261247,2197142,3066854,13473642,89998885,2022-12-31
3aca60463bad3a1c,verizon ,1010649,233965,13587,3316,1261517,2022-12-31
ae2c5caff06ad787,at&t,2269475051,54824302,36582975,744260,2361626588,2022-12-31
7d1e354d79cd709b,mint,3023375389,97210215,0,730,3120586334,2022-12-31
d893cf1d88924208,verizon ,53036436,3044513,18067,3610,56102626,2022-12-31
9bd2ee1d6b083dd9,mint,1747237661,92306620,48502,17672,1839610455,2022-12-31
8ce15ed6199a7bf6,t-mobile,0,0,47965,10655,58620,2022-12-31
da8b5303f30d6de4,,503792808,20347854,0,0,524140662,2022-12-31
0e4f24081197a4bb,,80564409,1321368,0,0,81885777,2022-12-31
f9409bf02ce89f77,pure talk,871534,278697,396982,118403,1665616,2022-12-31
8e3757861bcf9e92,mint,876383666,62702787,37376,18353,939142182,2022-12-31
472b9af8318f3c16,verizon wireless,498827076,29760281,0,84,528587441,2022-12-31
864d14d54a97137b,t-mobile,0,0,20831750,813878,21645628,2022-12-31
87f17301c43be295,,653626731,28329902,13994,325303,682295930,2022-10-31
4555645d3888688f,mint,862636,305665,288718,133419,1590438,2022-10-31
4e180d6bec43878e,mint,824108152,19418727,1014503,182576,844723958,2022-10-31
cde73cb3e6160cee,,124075800,18735055,6935,2356,142820146,2022-10-31
6849ea976a1c5f19,mint,808363,220998,51713,17175,1098249,2022-10-31
80f9ad5a6f588117,,155286829,2917107,0,0,158203936,2022-10-31
1e3c6cb88ad86dba,,7180,2284,315732,126683,451879,2022-10-31
6545392b814e33a8,,52311815,2392081,21131,6997,54732024,2022-10-31
05cf7384f7b34b5a,,73508,125109,0,0,198617,2022-10-31
238c8c3cfb179714,verizon ,0,0,866847,169197,1036044,2022-10-31
6e02426c9c3f61ae,verizon ,327992437,33149099,88390,27874,361257800,2022-10-31
791acfe3d2dd174a,t-mobile,399197725,4730316,0,0,403928041,2022-10-31
ffd36d79941f71fd,mint,421153,123876,27337,125869,698235,2022-10-31
761b6605ef57ac5c,mint,159776435,3313889,550,2598,163093472,2022-10-31
3d8336b0d32eba23,mint,855278,242454,538555,189259,1825546,2022-10-31
c9b57c8f12ae26fd,t-mobile,60614697,1479720,344100,242348,62680865,2022-10-31
62adb2ac973fc3e9,t-mobile,2316432,1875673,272641,87560,4552306,2022-10-31
7b39656275ff50fb,mint,298508877,4285925,0,0,302794802,2022-10-31
e3b6acfc8522aeae,home,844213,236639,726073,258112,2065037,2022-10-31
dd15d0b4e3bf561b,,149476749,2710244,0,0,152186993,2022-10-31
1e3363e498362f8d,mint,292717477,4603969,7713,2199,297331358,2022-10-31
d70de041f16d5b93,,55943777,706100,0,0,56649877,2022-10-31
02d11320a6032d8d,t-mobile,491026824,52291576,47624,11561,543377585,2022-10-31
c1c8b41fdae0b30d,,6317565,151031,0,0,6468596,2022-10-31
f2d99665a3bd7132,t-mobile,917261998,42879788,75648,25789,960243223,2022-10-31
572f11a70489f2e0,mint,1062420165,32224278,0,0,1094644443,2022-10-31
053390c909381ecf,mint,0,0,247520,86680,334200,2022-10-31
39e6f4b6b170a5ef,,48545173,612625,0,0,49157798,2022-10-31
6548d4aa1a3bb659,t-mobile,33612,22718,466294,266538,789162,2022-10-31
af36e446f3f13dbc,,28857,10393,0,0,39250,2022-10-31
7e6e8000d50dfb0f,,104163670,1618770,0,0,105782440,2022-10-31
48adf44f65832919,,50204987,1283829,0,0,51488816,2022-10-31
6a71c94fac2b777d,at&t,274181,186732,367709,176744,1005366,2022-10-31
ae7b0d6f99ffe86a,mint,1958717367,34941735,85921464,3826149,2083406715,2022-10-31
93c9b1f71452b302,home,0,84,0,0,84,2022-10-31
b991bd159e7b5ab6,t-mobile,541054568,6641983,14002,172675,547883228,2022-10-31
1356f89fed574640,t-mobile,103617566,2860198,0,0,106477764,2022-10-31
cc139eb2f9119b16,mint,58273,29836,0,0,88109,2022-10-31
933c06111357261f,mint,223784530,4120438,1948613,429643,230283224,2022-10-31
d39ec7c58b5bb544,at&t,716876,208860,0,0,925736,2022-10-31
47f64cfd99f8e6f0,mint,779960,214604,451034,675192,2120790,2022-10-31
f438149506fd795c,mint,422665333,26516323,1614812,182119,450978587,2022-10-31
79e6ab0f59414ab1,,872989,258948,166789,62190,1360916,2022-10-31
5f974c79ffa50273,mint,796990,472708,29984,10685,1310367,2022-10-31
00585fbf70848ec6,mint,0,0,809771,218609,1028380,2022-10-31
6b60b275ce4ec851,,61190766,2856294,0,0,64047060,2022-10-31
7e61c7d9758a744c,,17537541,549010,0,0,18086551,2022-10-31
f7601f812a6a590f,t-mobile,447802,135958,98300,40250,722310,2022-10-31
e59194d889f1f1d1,mint,1163901371,13636793,43116,10894,1177592174,2022-10-31
2a5146c51b59a47b,mint,749903,214175,0,0,964078,2022-10-31
b40c1d0ac8a592c2,t-mobile,939274400,82464937,134454,71683,1021945474,2022-10-31
6daeda51f04a049e,mint,708417425,62459605,852820,183185,771913035,2022-10-31
8a5b8a4486085264,,221870102,4073866,0,0,225943968,2022-10-31
efea30242364eb70,t-mobile,174925916,18535751,6672,1948,193470287,2022-10-31
44d45c0ce2d3901c,t-mobile,18516831,341166,218,823,18859038,2022-10-31
0c92ea8830cacc95,,816140416,33651330,53439,21348,849866533,2022-10-31
73ba72d51379d7f1,t-mobile,807169,233048,106087,29135,1175439,2022-10-31
6edb93e6edb418ff,t-mobile,781554,250322,145438,53785,1231099,2022-10-31
7c5fa433f9708103,t-mobile,583623692,34627802,14126,101845,618367465,2022-10-31
9b0871f315346bc9,,73593581,1389805,0,0,74983386,2022-10-31
38deae00a4ad5ac7,mint,579465392,28618641,680757,45236,608810026,2022-10-31
6a0d59178e9b7fce,mint,1137494330,69245920,498,2678,1206743426,2022-10-31
c62e1689a05a5ca3,metro by t-mobile,139707520,3814109,3416,46969,143572014,2022-10-31
492c109ab1ac7d1c,,148572745,2399917,0,0,150972662,2022-10-31
4bb9be9f770a5295,,64749573,894878,0,0,65644451,2022-10-31
b06ad99c68d4026d,mint,284662558,20724997,16882,4153,305408590,2022-10-31
5f363df3bbe13366,mint,170974458,18333175,0,0,189307633,2022-10-31
9fcbb85575e67c39,mint,439063607,62048498,1110781,204235,502427121,2022-10-31
712b0ce3db2c844d,mint,52944853,2518300,1454,14838,55479445,2022-10-31
382e640a05816766,republic,791191610,55711446,1058761,163257,848125074,2022-10-31
320d53fa3f4e494b,,973526699,26111221,0,0,999637920,2022-10-31
c4c3e4eb4fe35a3d,,475839217,42867749,0,0,518706966,2022-10-31
793502a7993b04dc,t-mobile,291399638,4657183,35067049,906904,332030774,2022-10-31
3aa1389c9bb2fa1a,,14876901,366131,0,0,15243032,2022-10-31
737937924a585a51,mint,366119,505689,29945,8100,909853,2022-10-31
dab91faf43948d33,ting,414264070,18545965,807755,71717,433689507,2022-10-31
967fc1e23f41a139,mint,342081018,30609063,544647,231421,373466149,2022-10-31
be5fa8bce252644a,mint,163106794,8182130,333876,129717,171752517,2022-10-31
24a7c6aeff04e182,mint,216594,176853,9939,2946,406332,2022-10-31
322c54dc84c6fe9a,mint,419616319,28006692,810538,144147,448577696,2022-10-31
9d6765e11193bb1f,,3438292619,46024419,0,0,3484317038,2022-10-31
0bd21c15b378ee73,mint,0,0,40143393,1993355,42136748,2022-10-31
1c107cffaa91feaf,mint,735055067,61185488,36717,15357,796292629,2022-10-31
548d5c77f3514eb1,mint,207287717,1843915,436,2609,209134677,2022-10-31
6f63a9310eb38656,t-mobile,563090653,52641286,92527,36021,615860487,2022-10-31
439337f24eaf6e24,,3378755,653542,0,0,4032297,2022-10-31
324bc905d9c78ce4,t-mobile,780568,301737,0,0,1082305,2022-10-31
aaca516e63c5071a,mint,19051,315433,0,0,334484,2022-10-31
a14890f6447f2186,red pocket,685254972,70679557,0,0,755934529,2022-10-31
e27539c9356c7ef8,mint,893886333,64185674,7007,2393,958081407,2022-10-31
301c805a05895afb,mint,434521055,4307153,20191639,843739,459863586,2022-10-31
28952e98449fd746,mint,0,0,961271,164750,1126021,2022-10-31
6545bfe43a3e2459,mint,739016513,55530816,57,69,794547455,2022-10-31
fab499ce75179a94,t-mobile,806719472,58985412,636059,42005,866382948,2022-10-31
b53531460d2d1327,mint,333563570,28964054,1284,9926,362538834,2022-10-31
7250bcf487c8125d,at&t,1685467069,79521442,6810,1753,1764997074,2022-10-31
7bfd401173a42905,verizon ,706226965,70137047,13666,4091,776381769,2022-10-31
7fbe519cc6ab31ef,t-mobile,1183745672,76512798,15288,3884,1260277642,2022-10-31
6bb65ef784db6cfd,verizon ,738692539,48186371,13291,2751,786894952,2022-10-31
8d5fd27fbb0f5180,metro by t-mobile,798555064,50464952,221621,87437,849329074,2022-10-31
e38f21077b7152ce,mint,52943715,2022137,0,0,54965852,2022-10-31
2fae274951e9637e,,77659637,1441507,0,0,79101144,2022-12-31
b256747e1786362c,mint,248618,68919,7490,1866,326893,2022-12-31
45b6603056b30d43,,257973152,4517763,0,0,262490915,2022-12-31
b00c7e6d4773eb37,mint,43062,10030,0,0,53092,2022-12-31
28a7a42d08ac4b7d,mint,146722087,2228322,3646,40508,148994563,2022-12-31
dc549f03266c0306,,1182461212,15149105,336378,138458,1198085153,2022-12-31
e28277bd694e327e,mint,256133500,4666374,0,0,260799874,2022-12-31
a062aa2465d83b3f,mint,740399346,24230022,799486,81598,765510452,2022-12-31
b2b97eec180e5e1e,,11374254,331602,0,0,11705856,2022-12-31
048ed1f1d5e4a3ff,t-mobile,450372,153974,19626,6721,630693,2022-12-31
62e3495a463fe033,,39628308,778383,0,0,40406691,2022-12-31
34e2b32d8013a991,mint,477722424,10171362,0,0,487893786,2022-12-31
59e1921707056c60,mint,735581,191819,318390,102008,1347798,2022-12-31
0cda80418136535b,at&t,1078817624,79665748,20065,5064,1158508501,2022-12-31
74ddadf2e7601d4e,xfinity mobile,2520779008,86948268,1468812,36402,2609232490,2022-12-31
16ca1bb6a6e1fe27,verizon ,3019091168,74694190,970909,202408,3094958675,2022-12-31
2dc8ba61d760565d,verizon ,1060538120,78527280,1434810,46151,1140546361,2022-12-31
d7d18b5003a73586,verizon ,374500050,27038322,27592,10768,401576732,2022-12-31
e2048d4461ad4b82,verizon ,1953156538,69820586,702199,12583,2023691906,2022-12-31
b02dc128b16068aa,t-mobile,503769097,10438758,55285,19151,514282291,2022-12-31
6a6326b141650830,verizon ,764809922,70210750,30170,14859,835065701,2022-12-31
8a92223cce40380e,t-mobile,721655895,66581034,1540961,81874,789859764,2022-12-31
3a95d4edb19651f2,at&t,387640838,46597840,6569,1701,434246948,2022-12-31
5338ee29b5fb78d7,verizon ,151636110,20552989,35855,8885,172233839,2022-12-31
0befff53aa37dee6,mint,1357295760,68142218,1790901,159376,1427388255,2022-12-31
362592424f44dc7d,verizon ,0,0,1038940,127061,1166001,2022-12-31
6a00fe161113de0a,spectrum,688331996,56924335,731754,17891,746005976,2022-12-31
bc259a6b980020c0,metro by t-mobile,588762972,5853209,1527540,108369,596252090,2022-12-31
c806581a3e0df784,mint,1350439502,43563698,33520,6787,1394043507,2022-12-31
6fa9b3e5b93034c1,verizon ,690697970,55122168,716096,12429,746548663,2022-12-31
17aaaf664b5f572a,verizon ,492727958,43070325,70696,24604,535893583,2022-12-31
c7abe506c6387465,t-mobile,861481129,61965326,61230,25525,923533210,2022-12-31
f6ea15c3dfaeb9b3,verizon ,781867418,79824022,1119987,173161,862984588,2022-12-31
3aecd11b4033f2c5,at&t,0,0,1486349,79765,1566114,2022-12-31
0a536dafa9ae6200,mint,842997165,59496133,1497516,71264,904062078,2022-12-31
4e152de0da6dd7d8,mint,785170449,60186232,917683,84095,846358459,2022-12-31
2bee853dc2062b7a,at&t,1023010457,61499553,74075,26295,1084610380,2022-12-31
efe35939f92b4128,verizon ,666777372,39135046,1083231,158731,707154380,2022-12-31
1aa606171ee7ab9c,at&t,963499819,62260283,796213,140139,1026696454,2022-12-31
b57e080aae7cef79,verizon ,141627282,1350622,901458,309107,144188469,2022-12-31
2b99e0c92dd6ead4,,927957658,18000858,21437302,263619,967659437,2022-12-31
39801657734d0be8,at&t,27116764,1709283,769890,63173,29659110,2022-12-31
ba5cf4339bc9fb86,mint,1183051517,75995548,1138055,99204,1260284324,2022-12-31
569c509c240cef16,t-mobile,566350693,46240972,1440480,163029,614195174,2022-12-31
f8f0cc9e610e4b20,t-mobile,662985393,16508931,6557,1847,679502728,2022-12-31
6b0a1ac2db8b7d5c,mint,27738,8615,0,0,36353,2022-12-31
51aa2ea246e56c8b,t-mobile,0,0,1151622,73611,1225233,2022-12-31
7e0e4dfa29c6f33b,mint,1429200,240491,36537,25883,1732111,2022-12-31
229ce6058e271a25,t-mobile,838119414,65887587,26297,7385,904040683,2022-12-31
a98e518f3391fe52,t-mobile,324956685,7408947,703681,54307,333123620,2022-12-31
bebf8173b7a8dc7e,mint,1364669352,70756704,27646,7397,1435461099,2022-12-31
551ec0a8fbd2f283,mint,1317969547,35998874,1453798,77861,1355500080,2022-12-31
0f1ac810f3c69577,,25157242,5174485,0,0,30331727,2022-12-31
b0c9b610231b2a48,mint,81410675,4478665,1508842,104084,87502266,2022-12-31
5275e8b2a7239e00,t-mobile,959753318,71795046,735461,48666,1032332491,2022-12-31
1e5d4303e4b57611,mint,465887788,30154834,550966,51581,496645169,2022-12-31
00e3bb1f3e08a39e,mint,1274065460,76279009,1447126,56028,1351847623,2022-12-31
c46caad20a2a5b9b,t-mobile,1687982558,43846088,1485201,206994,1733520841,2022-12-31
a397f13aed7a1db6,t-mobile,2455196513,45088372,13167,3547,2500301599,2022-12-31
b9b653609bcbc0fd,mint,1188495656,79180319,0,340,1267676315,2022-12-31
814215cba14e8f54,mint,1508801322,85765952,13416,3824,1594584514,2022-12-31
ad0b8c6d9f279d4c,,145848661,1851360,0,0,147700021,2022-12-31
70a9b1c1ca279f24,,189462956,2686682,0,0,192149638,2022-12-31
b47844f963afaa25,t-mobile,1176219244,85977521,722512,137518,1263056795,2022-12-31
93883c48abfb27f5,at&t,815136,250636,675797,213237,1954806,2022-12-31
f791dcc0484f22bb,mint,32280181,6033705,85831,31413,38431130,2022-12-31
16a1ec7a20797921,,146121308,22062955,119993,42944,168347200,2022-12-31
ae81e06b99fe9451,flash,724273382,67048553,98347,40983,791461265,2022-12-31
51998e00fecc2935,t-mobile,810090719,9127822,126174305,4281556,949674402,2022-12-31
fc99ba31ed563989,t-mobile,2644692017,40386656,1559649,293681,2686932003,2022-12-31
12feb43ca3b1db7a,mint,862972702,57654385,6672,1948,920635707,2022-12-31
f0cd40f75ff49a63,mint,764436917,53776741,21047,7059,818241764,2022-12-31
e210d23c4824acd0,t-mobile,1348134077,75092544,422144,84004,1423732769,2022-12-31
e050ff6e70daad26,mint,356060,99294,0,0,455354,2022-12-31
d54f1788ad4cfbf4,mint,781647053,25553369,793105,504741,808498268,2022-12-31
9bed2a5949ca135b,t-mobile,282053,76317,307,3182,361859,2022-12-31
f14af13f6f45a036,mint,124354932,2297184,39756814,1332784,167741714,2022-12-31
6f0ca6dd132ed553,mint,381994692,15458955,1108943,178535,398741125,2022-12-31
e4dfa5f5aaf4d370,mint,799413521,44514926,0,0,843928447,2022-12-31
894868353580629b,t-mobile,558940360,29639710,810057,164596,589554723,2022-12-31
bfddfb461f06a5b9,mint,326503686,9641131,0,0,336144817,2022-12-31
da28ab0b762f3f6c,mint,830231656,62191223,1064401,340399,893827679,2022-12-31
d7683d4b97dd21e7,mint,539435049,62625659,49498,15899,602126105,2022-12-31
392fa4602e266cc6,mint,1555648119,92469468,7579,5274,1648130440,2022-12-31
24df292678ab0c08,mint,114864531,4502980,43267,21612,119432390,2022-12-31
40981393ab03c7d3,,210104210,7681930,254170,93945,218134255,2022-12-31
0e67689138c78728,,29491951,883524,0,0,30375475,2022-12-31
8b324c33a7bd0419,mint,314345,528908,18658,123569,985480,2022-12-31
ca4b26b12d7bc09d,union wireless,1075038971,80134779,10788,2525,1155187063,2022-12-31
e24eb475a6aa1f80,verizon ,964188867,92604280,409426,27986,1057230559,2022-12-31
70cf50a637743ae2,,25876782,3758040,0,0,29634822,2022-12-31
a223c7816dffe784,verizon ,881090848,67109815,1457594,296507,949954764,2022-12-31
123eab75b085c9e6,verizon ,1650592114,63941015,0,84,1714533213,2022-12-31
aa6a7e292cf67a46,verizon ,117692692,1655356,399021,142165,119889234,2022-12-31
30adf35294b12b45,t-mobile,1976812137,90621678,0,0,2067433815,2022-12-31
6145d64e1e259387,at&t,0,0,43965,16858,60823,2022-12-31
0d07f9a2c4ecee91,at&t,323456239,27143798,976735,129252,351706024,2022-12-31
e20df60fadf54798,mint,661834895,14854005,340266,99648,677128814,2022-12-31
395557c357330825,verizon ,0,0,1497581,97402,1594983,2022-12-31
a63aa9c6f2852d0a,mint,720108643,65352692,2345874,340930,788148139,2022-12-31
59a60db48fa56b16,,1176806413,29010729,712380,13087,1206542609,2022-12-31
b80f44a02d2b5332,verizon ,858940865,73518066,1504456,63898,934027285,2022-12-31
c082e19413d43f14,at&t,1878924860,79758609,766467,80789,1959530725,2022-12-31
7e49b480ea85dd8a,verizon ,1125894751,58308639,1482165,65272,1185750827,2022-12-31
5bbe07e78cede8e6,verizon ,740009,209474,0,0,949483,2022-12-31
6ff88936a6a5913d,verizon ,1508161514,72894114,63872,22368,1581141868,2022-12-31
6b64bf6938c0ff03,home,573565768,44453524,12606,3095,618034993,2022-12-31
b6ae59de17418910,verizon ,183852846,21609668,1476311,62764,207001589,2022-12-31
b34c0f8a72da8d70,at&t,643399538,58293243,1589789,352049,703634619,2022-12-31
2c5ae741161b7f2a,at&t,915230827,81369472,771719,304835,997676853,2022-12-31
726e26d604bc43a3,mint,2235626401,77367550,462,8320,2313002733,2022-12-31
c4f4bf872ab1a052,verizon ,2570939821,98631235,22723,12203,2669605982,2022-12-31
b17fcee42c52d8a2,bell,262962189,9698876,0,130,272661195,2022-12-31
0c3e0e6671efc4cc,verizon ,946483495,80189549,850935,63603,1027587582,2022-12-31
e48689a8ab48f21e,verizon ,382080362,30427678,790317,57218,413355575,2022-12-31
734c178303b6a57e,verizon wireless,151659299,4882762,11629,430361,156984051,2022-12-31
93d5a48c4d180451,mint,1052180700,62484001,1775985,131007,1116571693,2022-12-31
fee9d1414fe7fe00,verizon ,14761600,3183988,112982,32411,18090981,2022-12-31
5c0fb993268e7676,at&t,1569303372,57786550,67877,17597,1627175396,2022-12-31
ddb55ebba647a884,,27003356,3678115,0,0,30681471,2022-12-31
06599beaf577f802,t-mobile,949776495,80069472,1500516,45017,1031391500,2022-12-31
f924b76ecc30b0c8,,19687720,449966,0,0,20137686,2022-12-31
0fcb9e2e5787d3f1,,612219045,14018736,0,0,626237781,2022-12-31
823d254b70ed75bb,verizon ,730650651,18613013,1511284,124836,750899784,2022-12-31
064b1e8ac538aa03,at&t,0,0,1054241,66286,1120527,2022-12-31
e99ac5c2f9b7212b,mint,1053965180,55871048,949156,118286,1110903670,2022-12-31
0a97ab1d2221be4b,mint,315711784,37944805,20878,6604,353684071,2022-12-31
ce69bdc9b675cdf9,,58093723,3241869,0,0,61335592,2022-12-31
e6aed37272d92cb8,ultra,0,0,644760,69039,713799,2022-12-31
9c494ad91196c481,mint,400807360,25618082,1104231,278662,427808335,2022-12-31
8fabd83fe5db5ff4,mint,181436257,11349744,6935,2177,192795113,2022-12-31
60f92282b858a49d,t-mobile,19830433,1550643,0,0,21381076,2022-12-31
f7dc7337b8ea36ec,mint,114347402,2984721,41680802,1829200,160842125,2022-12-31
df9e1eb8973607fb,,443518327,47263676,712996,104381,491599380,2022-12-31
cbbb7d6eccaecfe5,gci,159946802,3737259,0,0,163684061,2022-12-31
5e71d9526a975a55,verizon,164285644,6619520,0,0,170905164,2022-12-31
affabb91f0308ff2,ting,1335083622,95733822,0,170,1430817614,2022-12-31
c59af82881dcf289,t-mobile,902216417,80278885,1247249,222714,983965265,2022-12-31
e10a187575a53751,mint,631003353,17625856,2383335,271453,651283997,2022-12-31
93a6b48a8c9f1154,,513694382,11799032,19962,3750,525517126,2022-12-31
137222bc426ef45b,mint,969111830,58862683,1477663,173068,1029625244,2022-12-31
d5bb467e3610f426,tello,145662068,9975359,1995096,304318,157936841,2022-12-31
ec8597eefd972b9d,,159592142,4111401,0,0,163703543,2022-12-31
25afb258484fb3d5,,110609,249885,0,0,360494,2022-12-31
aa6f353a7645027b,,285184970,6940058,0,0,292125028,2022-12-31
20eb8d8ec9f85b7b,,662701353,49490467,49336,279794,712520950,2022-12-31
8706ddedc3c9bc0e,verizon ,813410456,63994829,1453461,50103,878908849,2022-12-31
333b0aa8550129a7,,330502381,15395000,7539,106841,346011761,2022-12-31
a0b355ce03976bff,mint,3027,9540,1948836,227808,2189211,2022-12-31
de0c4d9251906405,,131979686,2790756,0,0,134770442,2022-12-31
b52eff1fc9182523,,151921686,2285631,0,0,154207317,2022-12-31
b7034830c85c0997,verizon ,1151463021,81274833,1473797,103180,1234314831,2022-12-31
e6a38575920f83d6,verizon ,250207,1096005,30418,8961,1385591,2022-12-31
b59ab4927d9f010c,verizon ,7478179223,125175995,802704,90002,7604247924,2022-12-31
5af2f62673ffc915,at&t,1060338931,68556328,190023,66763,1129152045,2022-12-31
2b6528a2f669b439,verizon ,2302155065,104799870,59926,25455,2407040316,2022-12-31
f5165b056cee33e8,verizon ,284810549,5763391,0,0,290573940,2022-12-31
2913ee152223618d,verizon ,743925917,77390545,760107,36489,822113058,2022-12-31
16603505b11d2494,verizon ,419924198,10746936,1736109,92145,432499388,2022-12-31
eab106629ed8daca,at&t,656030639,45181897,1506140,64067,702782743,2022-12-31
01646e786810009d,mint,729732701,64119281,1473458,49606,795375046,2022-12-31
d1b0a212ee8391b9,verizon ,334528160,15297651,1478591,439658,351744060,2022-12-31
baad35c18609dd41,mint,126026038,2721813,0,0,128747851,2022-12-31
978d17f617c32a6b,t-mobile,2517187739,55693688,1204664,107512,2574193603,2022-12-31
dc28814d8796f87a,mint,644749561,55530244,66122,22945,700368872,2022-12-31
905332212ad72086,t-mobile,617433393,46041761,1266872,208481,664950507,2022-12-31
76d9ec153ade1a07,mint,0,0,1522121,99285,1621406,2022-12-31
7a0ee840af5eb7a5,at&t,1095959059,53511049,1538267,136428,1151144803,2022-12-31
c9be25ca12edc67c,mint,1174835856,78575131,770114,173822,1254354923,2022-12-31
41def6bf9d36d357,at&t,915599361,53505698,0,0,969105059,2022-12-31
7fb4de84a99246ab,t-mobile,399990740,29263672,1016121,227350,430497883,2022-12-31
8308f6ae85c20c27,mint,202965586,17179352,1944759,423324,222513021,2022-12-31
a077113858972daa,,690805891,46553268,721264,22111,738102534,2022-12-31
83803c657150dc83,mint,2065483657,99207895,51469,23345,2164766366,2022-12-31
0fd8260757202aec,t-mobile,1789335916,90633719,1466575,68510,1881504720,2022-12-31
8e13a66c1e8e343f,t-mobile,1008580863,75585686,1451694,30282,1085648525,2022-12-31
1b003319ddb40553,,144809820,2575007,0,0,147384827,2022-12-31
379a9ec5686b8df8,,1036116850,68575602,473,6521,1104699446,2022-12-31
fde6c979ff6d8b0d,,197811829,22940161,0,68,220752058,2022-12-31
602165b52d401be4,mint,808106283,50935558,1440977,25366,860508184,2022-12-31
f3aa72de5c816d62,mint,904951758,53907603,2696159,747360,962302880,2022-12-31
5eed9d1c7bb80b48,,3904018319,99534983,0,0,4003553302,2022-12-31
121b9a034428b926,t-mobile,828946255,66033700,13384,1810,894995149,2022-12-31
be3a8efd98344ec9,,230440964,8279983,0,0,238720947,2022-12-31
97e3f1e1860cb7be,t-mobile,1203657905,19864834,1099460,120886,1224743085,2022-12-31
01e576b61b6bbcd5,us mobile,1397430796,62461483,1654,12269,1459906202,2022-12-31
7c4456ab28cb99f4,at&t,490755722,13233081,0,0,503988803,2022-12-31
a586aebf51b7edca,,700927041,49614701,1264289,99433,751905464,2022-12-31
a27ab1c8269d45a4,verizon ,659724702,71775154,1477810,39446,733017112,2022-12-31
4aa0d44f58f9536d,at&t,1080005137,83989636,3198550,1215058,1168408381,2022-12-31
65e6133300fd5be0,,964144599,59384805,790836,127322,1024447562,2022-12-31
11f8a02b7e44ff0e,cricket,403584126,21472175,0,0,425056301,2022-12-31
7c2b32281109a3d3,t-mobile,1128099537,66108077,60141,16879,1194284634,2022-12-31
2965b4ac3bae7854,at&t,271858519,23013113,15649,23681,294910962,2022-12-31
a930b752b63399dc,verizon ,643977874,23403836,1040254,154560,668576524,2022-12-31
d681a06b042f59e3,cricket,1221524363,67124923,33317,10051,1288692654,2022-12-31
dffa75832b90f71e,mint,576210382,54398587,821234,41549,631471752,2022-12-31
a351c3252528642d,verizon ,934045386,67718121,712663,21334,1002497504,2022-12-31
67735d82d660bd3d,at&t,382135141,14721335,84091,29789,396970356,2022-12-31
50a28d64cf975323,mint,363002540,48763684,79835,619748,412465807,2022-10-31
68f2716998b4ec9c,mint,368667302,5271799,0,0,373939101,2022-10-31
46d48ecb75f91206,,205615847,17308601,0,0,222924448,2022-10-31
32b634b07f611632,mint,756755042,57262803,13659,5243,814036747,2022-10-31
174e948201ef270d,mint,865260043,30403352,693663,171724,896528782,2022-10-31
4cea21582dc8c3a1,verizon,73157646,9428627,0,0,82586273,2022-10-31
9e549fff354de498,verizon,83784,11200,0,0,94984,2022-10-31
ff9a81346bf14dcb,mint,638762524,51782202,1872990,285492,692703208,2022-10-31
e81946b60db2d764,cc network,284403854,3916797,0,0,288320651,2022-10-31
a86725efb79f804a,t-mobile,375749347,34914190,14133,2435,410680105,2022-10-31
e408a78e5ad3a508,mint,1062154,239052,6680,1908,1309794,2022-10-31
0e30692bdbe4106a,,139012191,10107005,0,0,149119196,2022-10-31
0d8baf42bb10686d,t-mobile,1506598422,74104353,90709,33648,1580827132,2022-10-31
b34a4fcab5fecdda,mint,1482174357,93281259,16555,9946,1575482117,2022-10-31
bdad27e287f4c3a0,mint,748211,194005,7383,1794,951393,2022-10-31
5c361f5258b4dbfe,,92660424,1934666,0,0,94595090,2022-10-31
8dc2d048489f91e1,at&t,570617431,45769482,1290371,91439,617768723,2022-10-31
2de772f1c313d43f,t-mobile,1668806916,71677258,1986359,295077,1742765610,2022-10-31
f141fc125be282f3,at&t,828136573,79824770,926017,128735,909016095,2022-10-31
f46481af44ce2562,mint,599158115,68324867,6534,1597,667491113,2022-10-31
247d656bde1cccbf,mint,687073794,56679886,876070,101738,744731488,2022-10-31
9d806acd9b80d882,verizon ,429605513,50687186,1033960,169640,481496299,2022-10-31
b510118e02863026,cricket,584880324,31988926,563996,143599,617576845,2022-10-31
5a98fca1d74a6cc3,t-mobile,1585932092,64653463,154669,60874,1650801098,2022-10-31
3d1e292279e2ac2c,verizon ,709711570,14160071,1990,22391,723896022,2022-10-31
f50a0cf5bf966dc1,verizon ,276874189,31893801,769807,101938,309639735,2022-10-31
34edc07ad7572e2c,,755388,271895,7535,1688,1036506,2022-10-31
4e45ca2e925d1cf5,verizon ,1140772286,57349541,24443,5470,1198151740,2022-10-31
e4a5953c64a08571,verizon ,0,0,1799703,282565,2082268,2022-10-31
aafc92d2e1384a7e,at&t,827309283,49447315,1323689,161091,878241378,2022-10-31
7051bfadec0e135c,verizon ,336514658,11290908,963243,119762,348888571,2022-10-31
5e62e0d2000d3cbf,verizon ,249618637,34227249,1007521,84582,284937989,2022-10-31
3c9a9602e9cc1d08,verizon ,922966712,67330086,1953294,270934,992521026,2022-10-31
656bc56fcd3f91ac,verizon ,590243176,66218069,1653850,197874,658312969,2022-10-31
774ec57df462efab,,148289297,2129236,0,0,150418533,2022-10-31
022a994b839f0a2b,at&t,346082401,20555487,11395,1937,366651220,2022-10-31
f2dc19592c4cd70e,t-mobile,789847445,67851656,709986,49093,858458180,2022-10-31
0aef7059ca009017,verizon ,41933446,9025499,476,1406,50960827,2022-10-31
088e0c902cb7e4bb,mint,1007720916,55898180,127741,44110,1063790947,2022-10-31
8d47f91e58a99fe9,t-mobile,608021217,53721961,1098238,209902,663051318,2022-10-31
8095d604d8d81695,,339353798,36202226,816676,117485,376490185,2022-10-31
b15d1e5277117e71,verizon ,269970278,33315342,691843,48673,304026136,2022-10-31
d066ddae5ebbaf7f,verizon ,12888457,1279390,0,0,14167847,2022-10-31
dad5156e1d92dad7,verizon ,585253627,74832426,14695,6141,660106889,2022-10-31
6392591ab0a42dc3,mint,2755881480,81897064,129974,42265,2837950783,2022-10-31
1e3674d875406fbe,verizon ,736889061,56906362,225,170,793795818,2022-10-31
5cd36baabdc892e2,t-mobile,1178152478,70713138,58178,15587,1248939381,2022-10-31
97683a1924348e70,mint,744562179,31127659,658708,34595,776383141,2022-10-31
2c28978d54ed5d75,t-mobile,672436629,43538460,364843,142972,716482904,2022-10-31
1129bc3256a139da,verizon ,765390880,55613315,1830,691,821006716,2022-10-31
925dac4bcb5fae17,verizon ,547055645,71403318,107456,37248,618603667,2022-10-31
5852631621429538,mint,909364823,74690127,1272280,279642,985606872,2022-10-31
757cc031f8805bc5,home,718130864,72411362,0,0,790542226,2022-10-31
f9aba7fe317b5e9a,mint,1109591973,37104890,1550332,237119,1148484314,2022-10-31
103597fa08c75bc7,mint,32072,7335,104,104,39615,2022-10-31
d29a484d850196ff,mint,0,0,677492,62132,739624,2022-10-31
f6947d5c748c454c,,862317,218463,0,0,1080780,2022-10-31
b54371a88c9dba6e,mint,250249544,16540055,241198,17296,267048093,2022-10-31
af0343661a3bf051,mint,459322257,15583891,965432,161365,476032945,2022-10-31
aa1e74a994629622,wireless,2142860783,86789031,787171,89135,2230526120,2022-10-31
b28a4b503a4b7e3d,,129400885,2516075,0,0,131916960,2022-10-31
e21f6820bdcaa61d,,36513,8275,0,0,44788,2022-10-31
b2dbdd357dd3eb70,,699453086,27148570,0,0,726601656,2022-10-31
ea1b0435737da1eb,mint,505112169,11559072,7778,4255,516683274,2022-10-31
3f1d941e36fd263d,mint,871173,252386,119740,39516,1282815,2022-10-31
7702dc62b24729d9,mint,619555331,45693469,0,0,665248800,2022-10-31
32386972a4d10138,t-mobile,827468884,76939588,104,104,904408680,2022-10-31
6d5f2ff5868e7ae4,mint,3248638875,105742619,1158472,191851,3355731817,2022-10-31
f9a42420e5310bdd,mint,3177465643,71783752,13700,3343,3249266438,2022-10-31
2d693f39297d4962,verizon ,1241705464,257840953,77479,25086,1499648982,2022-10-31
e4f9c114c3e24c59,mint,552615715,40267024,6297,1730,592890766,2022-10-31
47665c112666d98b,red pocket,992841204,78390468,1304821,110313,1072646806,2022-10-31
b36baadde54b6427,t-mobile,42920,32737,1003596,480941,1560194,2022-10-31
70b3a5ea9cf6cb73,verizon ,52495728,2266022,13427,3826,54779003,2022-10-31
083078bfcbfeba3c,xfinity mobile,3036250317,90233033,6802,1848,3126492000,2022-10-31
77ffa2147fed8335,at&t,493616898,57189848,987657,59252,551853655,2022-10-31
e735f0bab5cbe30d,verizon ,0,0,33956,9693,43649,2022-10-31
180a8eae95ea8d03,mint,562489699,48733405,1560565,216650,613000319,2022-10-31
e0474e2720cf3723,at&t,870185838,61999395,0,0,932185233,2022-10-31
8733d7a80e88f028,verizon ,905711022,18557839,2079009,355247,926703117,2022-10-31
578bb3a1d8d7b619,verizon ,362644685,24938094,671833,52168,388306780,2022-10-31
026686980a4a0503,,27851703,2338317,0,0,30190020,2022-10-31
cb4ab5c736db7ba9,mint,1267454817,69445248,113728,47161,1337060954,2022-10-31
578f0a34df056671,,809069,239455,343,2552,1051419,2022-10-31
6f313c551d36dd60,,440199027,29728460,0,0,469927487,2022-10-31
4d7c30f1f9646fa5,at&t,583302104,51494679,765221,66454,635628458,2022-10-31
39999fe0d9e761c9,,716024,263880,285142,79093,1344139,2022-10-31
f4f69621a4e5f33a,,513804854,12918936,742283,212645,527678718,2022-10-31
04d0e0840213fa94,at&t,0,0,160328,50182,210510,2022-10-31
e867320123334b89,at&t,165678518,9190489,22750,10154,174901911,2022-10-31
a43eb7633e19d0fe,cc network,498285342,64112469,788931,72303,563259045,2022-10-31
beb2e25f003e0a11,mint,750902751,49605528,0,0,800508279,2022-10-31
f02029acdde9c4d4,mint,7153833956,167573599,278290,147987,7321833832,2022-10-31
bb056399e62f37fe,verizon ,493930320,26262620,0,0,520192940,2022-10-31
4a476cc4038d1e43,t-mobile,397593,146366,1567438,334648,2446045,2022-10-31
f77d2e75c468e953,t-mobile,597008342,53394500,661324,33837,651098003,2022-10-31
a263b1ef5bc0702e,t-mobile,236798391,29885325,1987,737,266686440,2022-10-31
a8e868f782b349ff,home,46738652,2132206,351989,721245,49944092,2022-10-31
458406c8ef3c130c,verizon ,970400087,81899570,1290137,244636,1053834430,2022-10-31
0c93c3aa784d9714,verizon ,801729,284311,86983,29154,1202177,2022-10-31
1183f20a6eb75790,at&t,832561911,70428319,1908406,216682,905115318,2022-10-31
0214f9204be50856,mint,451044528,33279582,193149,67407,484584666,2022-10-31
5cf9de90ed4a629b,mint,177316033,3092082,0,0,180408115,2022-10-31
dc107d4ed897e222,mint,299401212,5596848,0,0,304998060,2022-10-31
38fe5f299eade996,home,232740426,4376422,21689,9076,237147613,2022-10-31
e9727d6b4ff84ffe,c spire,278085471,3391987,210040,191733,281879231,2022-10-31
2c1d07aa130fe791,mint,877035470,17036316,0,0,894071786,2022-10-31
b98609a3d077d846,at&t,307758904,4294245,201222,96320,312350691,2022-10-31
7f0346f9a0508d8a,,817917371,22994778,40,76,840912265,2022-10-31
0dea74e42e239fae,mint,713239264,30977712,208,293,744217477,2022-10-31
f4a58b5559c96b9d,metro by t-mobile,37840707,1579397,943473,287371,40650948,2022-10-31
893ac9dd48fec253,mint,1310533,338931,3789736,800396,6239596,2022-10-31
fb46c09dc4f58dd4,mint,489077,156095,182829,62479,890480,2022-10-31
14fa92f8c0fa687d,mint,205761798,10416534,1126292,187061,217491685,2022-10-31
7a36d0b52b548928,mint,578995379,17750178,6672,2105,596754334,2022-10-31
3a18692c58da95c5,mint,641074511,24231673,1308719,814093,667428996,2022-10-31
2c2759a31e5872ce,mint,696704743,30282852,1062184,183470,728233249,2022-10-31
42dc16e3d319bebc,mint,487216420,71902055,3385,5064,559126924,2022-10-31
de924efbd7481c44,mint,709544389,42811970,1533187,222286,754111832,2022-10-31
b543e0311beebf46,,49827979,905756,0,0,50733735,2022-10-31
d24202d82f867bea,at&t,6784,24328,98418,31314,160844,2022-10-31
54b3cc7c1abe5824,verizon ,595779726,52348104,5503,97224,648230557,2022-10-31
4c8c7f8321809434,at&t,97047937,2473913,1298065,76935,100896850,2022-10-31
b5817cbdf8d7dd93,mint,977889585,54511722,727444,259702,1033388453,2022-10-31
5eb09758bab7f091,,735729075,56913649,476,1989,792645189,2022-10-31
70770b8fe8d5b6bc,,692097759,53925747,0,0,746023506,2022-10-31
76ea9d5fd5b84c2f,at&t,498918604,42138945,703886,123945,541885380,2022-10-31
b244a4b69c0af23d,at&t,77853965,13724721,200229,66700,91845615,2022-10-31
d4f686d6e1141f1f,at&t,769646359,33710635,2173778,257551,805788323,2022-10-31
7d0243310c77918b,,64360919,991185,0,0,65352104,2022-10-31
daa3b9092ba2e0cc,at&t,1357750166,77820689,6758,1701,1435579314,2022-10-31
691f49953d3948d3,verizon ,10687402,2107031,1155448,236624,14186505,2022-10-31
90f8a069678475d1,verizon ,795002309,40384908,928289,113882,836429388,2022-10-31
8b8832de62c67f94,verizon ,783011087,74383538,27211,7870,857429706,2022-10-31
c50b6371d39c0784,verizon ,1451070180,93470992,6661,1793,1544549626,2022-10-31
5e9ca9d2dd825236,verizon ,1730291959,78542518,35164254,1612403,1845611134,2022-10-31
5772a07b3e8b576c,verizon ,235156053,11599312,1357510,244793,248357668,2022-10-31
f8b6ef821371b4b1,,148164354,1821181,0,0,149985535,2022-10-31
9ab49376ddd2ca4a,at&t,0,0,140683251,1373316,142056567,2022-10-31
8fe6e264b700fa37,verizon ,810628088,69213829,1931375,440852,882214144,2022-10-31
148f6bdc3b2302a6,at&t,635563247,52521789,10867,3654,688099557,2022-10-31
a44e2eba202dcbf8,at&t,667855217,61758074,0,0,729613291,2022-10-31
3dc285149e2b68f2,mint,933647478,65824036,238378,24280,999734172,2022-10-31
dfb5662c6c54269f,verizon ,386086884,62662033,6345,1977,448757239,2022-10-31
37b773d882061a9c,t-mobile,396739271,11904092,23822,7680,408674865,2022-10-31
7f4fb4c025ae3b65,mint,1477266,49108,204503,79440,1810317,2022-10-31
d0a1acb7c43039df,pure talk,21033865,4187341,1350350,92909,26664465,2022-10-31
196a41b759f3dd2b,xfinity mobile,12203347,1682187,49560,15818,13950912,2022-10-31
cfb636b9d94562d3,verizon ,12413310,1127925,0,0,13541235,2022-10-31
a030a1a5891e48e7,mint,870255,229889,43133,11547,1154824,2022-10-31
78fc34f34e365a80,at&t,788405,258730,462366,121982,1631483,2022-10-31
4cc7627cf2052b2a,t-mobile,98689,28609,913427,273465,1314190,2022-10-31
3bee639d9814af7b,mint,429434978,49667806,609040,26964,479738788,2022-10-31
9d1ca21d29cd7c26,at&t,386520560,41430832,0,0,427951392,2022-10-31
fca75be44766d4dc,at&t,2457298905,28930517,2541589,449677,2489220688,2022-10-31
9c1a0ee588821b55,mint,880103,242758,16502,7807,1147170,2022-10-31
2b935cc4ed807595,mint,39005472,1380070,0,0,40385542,2022-10-31
475e9940fcc41f7a,mint,844388406,41674621,635347,33790,886732164,2022-10-31
4755de5dd56bec9a,mint,237973091,5043925,0,0,243017016,2022-10-31
d296941cde7c6622,mint,1565827612,37978113,0,0,1603805725,2022-10-31
53b990836121422a,,25649,10487,0,0,36136,2022-10-31
5177ed8c3f4b6b67,mint,414920969,22984931,418,170,437906488,2022-10-31
f9ef5830c4fb8a3a,mint,1035119997,74138282,700897,148303,1110107479,2022-10-31
b8125a2465799323,,49798378,867361,0,0,50665739,2022-10-31
ba0b5c92853d17a3,t-mobile,1610164541,59943681,424421,163297,1670695940,2022-10-31
458c11df38b60547,mint,185447,63438,248177,73707,570769,2022-10-31
15533fe1306f2156,t-mobile,389893202,31638451,44551,15768,421591972,2022-10-31
cf57b22c69319f11,,669736,182922,104,104,852866,2022-10-31
75b4136243164104,,176043614,4186067,0,0,180229681,2022-10-31
55e6afdb0d372c98,mint,1214423570,39857281,812184,79613,1255172648,2022-10-31
31d88b194c204223,at&t,346935359,50616517,39103,17753,397608732,2022-10-31
c72027311a1e6bc3,verizon ,512465365,33444372,84,84,545909905,2022-10-31
342cd4b75a747478,mint,384361338,58025446,753470,70986,443211240,2022-10-31
d7ff423363e0cdda,t-mobile,2192209207,43013337,1352390,82746,2236657680,2022-10-31
24b275d702da203e,at&t,1071939991,29674536,0,0,1101614527,2022-10-31
44ea28134a2b1214,verizon ,290990585,1741466,84,84,292732219,2022-10-31
c605ef4a94a6c710,verizon ,876245,304163,111921,37396,1329725,2022-10-31
20a45840ed1ecf5c,verizon ,591236369,52867721,39388,13994,644157472,2022-10-31
1ef718e48a910a86,verizon ,630409149,27477885,226793,99474,658213301,2022-10-31
3b727c131c5b7f56,verizon ,1231299992,72464164,996357,132846,1304893359,2022-10-31
ded0f912dc292819,visible,252521343,25080559,826925,89868,278518695,2022-10-31
e6074c9e78bd5608,verizon ,495743101,11173806,796599,87876,507801382,2022-10-31
6ad0257026e18f21,verizon ,100816459,1040119,2159162,787819,104803559,2022-10-31
569c4724f5c46cb3,at&t,695085827,11801396,1767138,248841,708903202,2022-10-31
97b6208b43def2ca,verizon ,1255537251,37639402,36407,8373,1293221433,2022-10-31
0f97d3251fd498d0,at&t,4871893060,57499595,15706,4937,4929413298,2022-10-31
0b3816f25e6f96a2,verizon ,544231933,59458517,68014,22722,603781186,2022-10-31
30ce82be361fe324,verizon ,450590085,27855417,100745,38163,478584410,2022-10-31
2a21e3920707f7dc,at&t,429824031,48438756,6951,1912,478271650,2022-10-31
51e478861aec3498,verizon ,891693845,61667638,1760820,205038,955327341,2022-10-31
8058e83352995681,mint,2101294546,94510503,705205,38754,2196549008,2022-10-31
ed675e8a54519109,,262326358,17305567,554234,61703,280247862,2022-10-31
5590290a24187094,verizon ,2991304422,57035518,1146799,59850,3049546589,2022-10-31
490229fb1766b03f,verizon ,693481278,74840294,931565,153858,769406995,2022-10-31
298576fec9e97382,at&t,1708311884,88200370,2067490,576342,1799156086,2022-10-31
0915b05fc2a3f546,t-mobile,333219742,46055244,6935,2212,379284133,2022-10-31
778e3070af11bc8f,at&t,1959208071,87257062,1605150,158544,2048228827,2022-10-31
dbdc129b3a08dc40,mint,0,0,1332102,111082,1443184,2022-10-31
ecd45a53660b46ca,mint,578380825,46395462,1153725,228625,626158637,2022-10-31
7187b2a08efab325,mint,277507472,17037711,20016,5484,294570683,2022-10-31
56673a271758ac91,t-mobile,17167323,4499561,2704549,299909,24671342,2022-10-31
2b138c274885e4c8,t-mobile,563243807,64133239,52,211,627377309,2022-10-31
b938be4856d5dc3c,t-mobile,279431921,15861113,1242927,330888,296866849,2022-10-31
68e077b51d00d591,mint,2314417397,61923483,104,104,2376341088,2022-10-31
6b337d14cffd41fb,mint,781854224,53775101,90999,34916,835755240,2022-10-31
4a7e0a6d94b84bd6,mint,400569391,60012704,258226,85800,460926121,2022-10-31
f08a4ab28c395a16,mint,703755411,91828113,19417,5053,795607994,2022-10-31
8736f2e2f8568824,t-mobile,576611829,26184339,0,0,602796168,2022-10-31
83c7d315d094de9a,mint,3336101376,107751650,1189615,240988,3445283629,2022-10-31
f5341d5424ed6b8b,t-mobile,577699611,65521963,7044,2356,643230974,2022-10-31
4db969f29158141b,t-mobile,629952200,85744026,126844,62573,715885643,2022-10-31
6091bd81df0f137f,mint,284187466,10547210,682950,43484,295461110,2022-10-31
a25f196afd3bd01e,mint,241310521,5054986,0,0,246365507,2022-10-31
d2502cbde090438f,,50492408,1702186,196160,62774,52453528,2022-10-31
8f05954e6a5b36f4,mint,347545872,24753557,1942818,298404,374540651,2022-10-31
5961a463dc00dcc9,,391325601,20410058,0,0,411735659,2022-10-31
7946cc4c924e2743,mint,583748825,23520556,3591,33973,607306945,2022-10-31
ab6f371146093b1c,t-mobile,636856886,33967645,987735,162681,671974947,2022-10-31
9bc03e995fb8e724,mint,161075299,1874661,15022,3814,162968796,2022-10-31
a979b839b1a28a3c,mint,582677117,64213933,1124393,237278,648252721,2022-10-31
7ab608975e41b093,,429289751,4776643,108171426,2829831,545067651,2022-10-31
4b4d8897e97db932,mint,0,0,842411,264976,1107387,2022-10-31
897e0bc6a66fc0d5,mint,881638724,71109049,14205,2435,952764413,2022-10-31
a4ec344025381720,mint,700793602,60271243,1563171,252026,762880042,2022-10-31
abbfb28a1b1dc860,mint,966768393,42846930,1361854,311742,1011288919,2022-10-31
0f0c3c8fa0295b9b,mint,400426138,51228785,834072,103238,452592233,2022-10-31
a8f71840f61aa9cb,t-mobile,1586224555,54454450,1879804,392989,1642951798,2022-10-31
1e2ee45528a74030,mint,522552228,35370734,6393,2270,557931625,2022-10-31
eac8e701b6eae8b8,ting,749992929,72988069,0,255,822981253,2022-10-31
8f22698f7d79bdd1,mint,196504762,6516683,868164,167045,204056654,2022-10-31
477c53d3911da4de,,291003828,8697099,41565,10935,299753427,2022-10-31
b109f717c3d79f87,,1549605498,39029620,805,6236,1588642159,2022-10-31
13d690ca03d4765c,u.s.cellular,821048553,59413750,129081,42528,880633912,2022-10-31
c048125c8f216a1d,at&t,2209063786,96054149,22966,528279,2305669180,2022-10-31
7119552a2a26ec9c,t-mobile,345745386,39667050,104,104,385412644,2022-10-31
ad13cc046db6bab5,,146090942,16484084,0,0,162575026,2022-10-31
11ed34c4723d008f,t-mobile,485150,47274,772373,158412,1463209,2022-10-31
1f4cc845bd20408c,t-mobile,265417290,31527534,1434936,211854,298591614,2022-10-31
446b8b135e6f8b57,mint,793750,223484,595708,180496,1793438,2022-10-31
6275c12f2a7137ea,mint,278683,763909,37731,10494,1090817,2022-10-31
364ff19bc4f7a271,mint,0,0,897057,237635,1134692,2022-10-31
eb66dbfb05b2ef12,t-mobile,849631,252213,668956,454876,2225676,2022-10-31
6b6cc96c7a8a0977,,38043,144001,0,0,182044,2022-10-31
435870ff2d4112b6,verizon ,73033561,4134818,138609,60840,77367828,2022-10-31
bfe3c8899db72c0e,at&t,1648505807,76781486,2873,60840,1725351006,2022-10-31
b6ef81f48253adf1,,554911215,24887124,0,0,579798339,2022-10-31
a6e1c1fdace0bd7c,us  mobile,696299021,61728056,0,3170,758030247,2022-10-31
2bd72cba55616e91,verizon ,828208148,53990335,241993,8245,882448721,2022-10-31
622a1172e83bdeb9,verizon ,765353950,47650275,1940396,346471,815291092,2022-10-31
5184561b35734ef3,verizon ,6901647034,117063982,18757,11246,7018741019,2022-10-31
c746891f20845b4a,at&t,972318014,68708312,610642,6669,1041643637,2022-10-31
2893de04cc4a2325,verizon ,740568493,67519623,47652,13421,808149189,2022-10-31
90a4f8f6b6b93111,verizon ,81589111,15253960,0,0,96843071,2022-10-31
25780fd5103e6ce7,verizon ,1185398625,79114671,1237224,135886,1265886406,2022-10-31
079f8e66e1d4a846,,667927610,44689157,0,0,712616767,2022-10-31
4a7f5f7629c201fe,at&t,0,0,681589,79332,760921,2022-10-31
3a20f9f343514aff,verizon ,719483,217893,15218,3030,955624,2022-10-31
cbab99bc9e580117,sprint spectrum,17568,6919,0,0,24487,2022-10-31
737d554416f4290b,,551321635,26094864,720164,83299,578219962,2022-10-31
1066094ea01c089d,verizon ,797232429,71831776,1191972,192717,870448894,2022-10-31
64476294068eace7,verizon ,415459400,65324639,1296775,86148,482166962,2022-10-31
7f5f3a5a9c6442b9,,59860323,9700454,0,0,69560777,2022-10-31
5aecdcb8c1fb92c9,mint,147752696,13813541,48359,56275,161670871,2022-10-31
e01950f5639e42c3,verizon ,526418625,57918709,84,84,584337502,2022-10-31
c5cdba2cec2a2a58,mint,736369373,34754527,1979081,288726,773391707,2022-10-31
68ea1396524a1e93,verizon ,236810103,25212405,2063462,309543,264395513,2022-10-31
0f3c3f8b4494d117,xfinity mobile,706583756,42489492,416,170,749073834,2022-10-31
7ed904de7e086e2c,mint,860584117,70489421,982384,138795,932194717,2022-10-31
b1f437552ed084f0,verizon ,612399719,59216402,1537286,130505,673283912,2022-10-31
0b164950f9e499fd,at&t,952337134,41097336,84,84,993434638,2022-10-31
b9c8cb6a424742ef,verizon ,985111895,17699295,251,7577,1002819018,2022-10-31
6556e738f153ca95,verizon ,0,0,188302,57719,246021,2022-10-31
dee9200b5e639099,Â ,113495593,6188647,817585,146634,120648459,2022-10-31
2ff2931125081233,mint,3902256632,122146296,29942,12021,4024444891,2022-10-31
68bf967005fafd3a,,680424227,43006069,654166,66171,724150633,2022-10-31
e9f6e7aa4f79578f,at&t,620759213,58720454,713316,55892,680248875,2022-10-31
6102b07b142a18c3,t-mobile,7751137882,94519625,418,250,7845658175,2022-10-31
3423dbd74ff3e976,,183434660,1893348,0,0,185328008,2022-10-31
84376616c44f0bc0,,221288552,5578949,0,0,226867501,2022-10-31
a37e258672b4e2c3,mint,1371100245,38173248,745031,68994,1410087518,2022-10-31
16d4db501be427d8,t-mobile,199589210,14034509,377367,108238,214109324,2022-10-31
a3b91683545a5bf7,mint,244903707,11068484,214508,74616,256261315,2022-10-31
7f520fb781468a4d,,835465,263688,131485,45799,1276437,2022-10-31
7930d78a502bf403,mint,2495179248,68899311,127242,47358,2564253159,2022-10-31
1a94bc92c5652cb3,mint,745854801,71911319,6914,1846,817774880,2022-10-31
2359799dee3aa08f,mint,353327082,20632036,718176,456192,375133486,2022-10-31
c98eb3475c8d9d6a,mint,834377178,44863280,633154,154991,880028603,2022-10-31
0b851cf4fa0c1758,mint,1267900704,49416609,0,0,1317317313,2022-10-31
2f54449a77d78bd1,t-mobile,610945874,76363073,884645,133925,688327517,2022-10-31
5570907b192db486,,267997240,23348125,0,0,291345365,2022-10-31
846384839abc3352,t-mobile,623393879,53299605,800002,83651,677577137,2022-10-31
98028bcb4d2d0ac2,mint,206094942,8123181,1107952,210903,215536978,2022-10-31
69722592d9771bb3,,24800253,8781950,0,0,33582203,2022-10-31
ed75e71f4b7d8997,,239232654,4040367,0,0,243273021,2022-10-31
5a805caf09275c5b,,200510808,4047052,0,0,204557860,2022-10-31
79c312ad424cb359,,209838667,3829412,0,0,213668079,2022-10-31
58af72ea25fb834e,at&t,2665921657,58766018,0,0,2724687675,2022-10-31
404412bdc2a1534e,verizon ,928717,484625,333067,121221,1867630,2022-10-31
0fe3eb4cb5551b7e,mint,297598487,37399525,1042299,196757,336237068,2022-10-31
d1ee7ff2530fc8a2,,168016548,2192827,0,0,170209375,2022-12-31
ee57e4d6f2d21f8e,t-mobile,245859643,5300936,748808,35797,251945184,2022-12-31
d033cea3da38ba3f,,565221810,50766768,6574,1689,615996841,2022-12-31
429dc13e543fc2f3,mint,1536423873,73147319,760401,37877,1610369470,2022-12-31
397236ef629d9b53,at&t,1410982695,68217428,0,0,1479200123,2022-12-31
070d96ec12441bd3,,662980157,68186290,161457,46115,731374019,2022-12-31
0b49cbe99b8a6fc8,,1434375086,88930553,1285909,57349,1524648897,2022-12-31
9f52c2a9268b85e7,verizon ,992199195,59719935,1910162,169544,1053998836,2022-12-31
64f7e28478990b5b,verizon ,986429744,87710706,90798,28484,1074259732,2022-12-31
bbdba743db988a24,t-mobile,2752302728,16168964,919972,102801,2769494465,2022-12-31
c862ce9bb7dac513,verizon ,2678928984,69979788,762134,29186,2749700092,2022-12-31
7ee264848b0edfb3,t-mobile,0,0,262013,91723,353736,2022-12-31
7c50ad49af6b7809,mint,807899816,61475617,742937,32508,870150878,2022-12-31
6df299f782eb26a4,mint,1700577323,60669851,713800,33601,1761994575,2022-12-31
05a606aa19e979fa,t-mobile,662256161,48289254,736974,40285,711322674,2022-12-31
f8bd2ae29adbee71,t-mobile,545257285,40987746,1427741,61106,587733878,2022-12-31
8e5e9ffb6f12a6de,mint,422039655,28347668,1452433,56342,451896098,2022-12-31
7f29fab88fd61596,mint,628287803,55839242,760434,33396,684920875,2022-12-31
e4652efc4d734a0a,mint,1908639357,58896358,1468415,73039,1969077169,2022-12-31
a272cfbd836fade7,mint,0,0,726312,25040,751352,2022-12-31
db9f1d54a4ab30a9,t-mobile,609724309,46023220,713640,8003,656469172,2022-12-31
05f99bcb46b0d2df,mint,1462742017,59548645,725266,23770,1523039698,2022-12-31
f0b8ae673e03ecd5,t-mobile,445613680,41125471,721033,20769,487480953,2022-12-31
b4437d1999c694ba,,157624788,1434117,0,0,159058905,2022-12-31
062189217d8ce06f,,1166124866,21990446,0,0,1188115312,2022-12-31
d1e6a7d13511efa3,mint,858996674,44732247,1453832,35016,905217769,2022-12-31
c9c6209e402b8bdb,mint,620331933,49191793,1651720,97301,671272747,2022-12-31
c6d99c4508924b6e,verizon ,1280146351,98549098,1474641,48291,1380218381,2022-12-31
fbfd9ec0f19c625d,at&t,361320162,30175583,728831,34253,392258829,2022-12-31
7b319e15f8a7d608,verizon ,851259189,71448676,1493233,58650,924259748,2022-12-31
980d7c52d81f8676,,412392706,35274214,1673784,164743,449505447,2022-12-31
d0646d2a4e5a3c47,verizon ,648064557,36204384,123640,35721,684428302,2022-12-31
0484af072abebac1,t-mobile,729051944,70807432,1649126,122429,801630931,2022-12-31
12e1dfaca5d8916a,mint,891578964,83914936,259400,52735,975806035,2022-12-31
c6535045783bb569,verizon ,706668702,65955030,932515,94573,773650820,2022-12-31
bec7c02de43d638d,mint,934195651,53431691,1470612,73091,989171045,2022-12-31
3873f88a194fa662,at&t,2193334912,24202866,2333421,402826,2220274025,2022-12-31
2ef08656bd1043a1,at&t,868183204,80807982,1481134,53416,950525736,2022-12-31
c3b0999f78fcbf43,gsma,543947686,26895240,49010,15347,570907283,2022-12-31
59f224b3d58284c3,ting,620633776,65951192,64339,24159,686673466,2022-12-31
84305707045a6265,mint,1255222193,80423668,1526161,102190,1337274212,2022-12-31
18e1399810291bf7,t-mobile,284704649,15723276,1471411,52406,301951742,2022-12-31
b7e09ca2b99d0268,t-mobile,916269562,65772336,2143410,182409,984367717,2022-12-31
6d67f5fd4a3f29a0,google fi,1434847711,77327549,1502898,83366,1513761524,2022-12-31
c811a0b3554573af,mint,1003019285,73927105,29987,14431,1076990808,2022-12-31
ff7c504c91bac8c9,at&t,878194256,45695879,2147567,335805,926373507,2022-12-31
9bca2fc71d5482e0,verizon ,815296228,72671208,63860,19421,888050717,2022-12-31
241ecf2b58254361,verizon ,1032559452,81207287,774745,47465,1114588949,2022-12-31
995184913834d979,verizon ,1040026588,93068270,1500183,61086,1134656127,2022-12-31
a30981e3cb4541e9,mint,1001144390,92960204,1458294,56228,1095619116,2022-12-31
a3da4d81947c2f0b,verizon ,336535814,11330304,1461,552,347868131,2022-12-31
df66b6703835f50e,at&t,194301127,10453554,29597,9982,204794260,2022-12-31
6c0fc871453099e8,mint,415817105,39023392,123976,40952,455005425,2022-12-31
13e954d1af46a452,verizon ,731047526,76427218,1455843,45976,808976563,2022-12-31
ffbabf40e3d736e8,,155930604,3778242,0,0,159708846,2022-12-31
3d799182b84f9d91,mint,791550767,62309626,2051079,422472,856333944,2022-12-31
d258605ca38a7bad,verizon ,659925651,24413980,1496119,84337,685920087,2022-12-31
dbff54f4e48924f5,t-mobile,974678378,51229510,1681925,121695,1027711508,2022-12-31
ef029995650251e6,verizon ,764612499,65646606,813647,60803,831133555,2022-12-31
fadd7be9a3c72848,verizon ,878971892,68083356,1498579,51276,948605103,2022-12-31
b5bf0fb3f76277eb,,1847805756,29539570,77274,26930,1877449530,2022-12-31
70388cf687ad88f2,at&t,225068652,19376752,1200923,110010,245756337,2022-12-31
7ca2b8864e478f2f,at&t,216081943,21617119,58332,34255,237791649,2022-12-31
6a035f5070947def,ting,440403876,5360873,1372493,63426,447200668,2022-12-31
eb2d6f1f103221ad,at&t,431484591,39332812,709947,9111,471536461,2022-12-31
02c558ca13bb9644,mint,788429474,51905631,24783,15666,840375554,2022-12-31
2870742ef03bd08a,,49776,23105,0,0,72881,2022-12-31
62ea90bc7afd3159,mint,33313647,5241820,756581,52881,39364929,2022-12-31
81c2abd0d6ea198e,t-mobile,138405847,10764531,807692,52263,150030333,2022-12-31
5d7e1c68d841e5d6,cricket,45298856,1987775,1481997,111096,48879724,2022-12-31
14546b7354c3b361,,390487511,10236469,1143381,222589,402089950,2022-12-31
1b77abf9abb846af,mint,666970651,33070649,104,104,700041508,2022-12-31
88b270bf00ba1a86,mint,1133860123,36190821,1441519,69720,1171562183,2022-12-31
f9c4bf1e34d9bf5e,verizon ,925846847,35006761,1494912,86731,962435251,2022-12-31
8502ffe445674a40,mint,847239632,43177332,2193983,437674,893048621,2022-12-31
a9dca2f9750db3c7,at&t,1199922224,48279624,170424,54315,1248426587,2022-12-31
97678956b6201b3d,t-mobile,877379462,55954138,756163,40892,934130655,2022-12-31
345d8ad80b24c954,t-mobile,837423079,55228271,1530363,90986,894272699,2022-12-31
fdc2e7ad666a2a92,us mobile,859916167,39034677,23289,11783,898985916,2022-12-31
50acec7084f84e6f,mint,959154994,50636544,52006,22860,1009866404,2022-12-31
bb324d84feaa1374,mint,1807404749,61642637,1443200,58410,1870548996,2022-12-31
ef0833875d5a07cc,mint,774008352,48082372,1435165,58836,823584725,2022-12-31
ae51c0c1fb743530,mint,462672359,14264534,1458527,60946,478456366,2022-12-31
d62919fb330caa7d,at&t,1385457684,76969533,720624,27642,1463175483,2022-12-31
6278358da9707dae,mint,727847247,57225050,1441307,30878,786544482,2022-12-31
99d4d21b522eb8fe,mint,1022147677,82679603,26827,8047,1104862154,2022-12-31
f0c58bd37ec22c44,,187473383,4213073,0,0,191686456,2022-12-31
49736b652b3576ae,cc network,5408098182,101793816,65195,23325,5509980518,2022-12-31
c475ae303040ef8c,verizon ,570307412,65062641,1280216,82984,636733253,2022-12-31
d182089719fb6d2b,at&t,0,0,249939,112612,362551,2022-12-31
57b98360642895b2,mint,1303493445,60605384,784371,621724,1365504924,2022-12-31
e6b60674a82ff1cf,at&t,915864130,71456843,742367,22876,988086216,2022-12-31
00d0f5bc0d746471,,1454315014,86799189,28253,9572,1541152028,2022-12-31
9f611b89cb812179,mint,1010701873,64233251,780290,37616,1075753030,2022-12-31
ed97a9841a3639be,verizon ,1543434181,98112667,1736196,137813,1643420857,2022-12-31
615202db51fa0cf9,cricket,852925603,46217713,850080,79983,900073379,2022-12-31
1e6e3b350805fea4,at&t,636925479,43605693,732718,63511,681327401,2022-12-31
cef105b8eb4157a4,t-mobile,695025353,50739569,765893,45547,746576362,2022-12-31
e043b7c8b2b3fff7,verizon ,4137312502,59837589,15217,5599,4197170907,2022-12-31
17a09e8ed7c208fd,,175459892,3139104,0,0,178598996,2022-12-31
a127af898745a5f6,mint,913453341,67554535,1446380,25408,982479664,2022-12-31
cea667ac91bcfcd9,,80777649,1917576,0,0,82695225,2022-12-31
72992bb2882789da,mint,730994955,62383557,1463583,69371,794911466,2022-12-31
2a24440c0dbaf69d,t-mobile,404163841,42899022,0,170,447063033,2022-12-31
380bff665dab51c4,red pocket,540874491,44993089,1367613,83326,587318519,2022-12-31
f83abc7549ec14fd,,75406687,1568028,0,0,76974715,2022-12-31
a0383b6ce0beb2e6,t-mobile,781072318,55977923,16376,10836,837077453,2022-12-31
77c0f374c7381bc8,,276569409,2680242,0,0,279249651,2022-12-31
fa28c75fb996c0dc,mint,945131144,73123202,718362,16126,1018988834,2022-12-31
86e96de109cb0dfe,mint,1521144165,92576378,710049,15569,1614446161,2022-12-31
c41c230f857f2318,verizon ,894620094,67548583,1463724,43313,963675714,2022-12-31
15d41fdda4ab2f27,verizon ,661642090,28130647,1468631,113824,691355192,2022-12-31
8f2beecad0173aed,verizon ,1023334266,71014574,1450243,26061,1095825144,2022-12-31
96c603ecbe6ebc39,t-mobile,1611469050,75732381,1522476,60063,1688783970,2022-12-31
a7971e3d13907b0f,at&t,8202843383,75734712,1395301,144768,8280118164,2022-12-31
85423d11c23654db,verizon ,709479847,72811903,1447479,55011,783794240,2022-12-31
aa88700d09d30308,verizon ,788501630,39710129,1498046,72616,829782421,2022-12-31
2d819c73bfd4f850,,19070916,886916,0,0,19957832,2022-12-31
55c68f1473799dff,us mobile,343774883,13538650,1465936,92133,358871602,2022-12-31
c124a94b4aceffdc,at&t,2251285043,30172935,722302,13940,2282194220,2022-12-31
06ee2253a9be75ee,t-mobile,1272605371,68912956,2946973,726717,1345192017,2022-12-31
a0acf005242de11e,mint,1025061949,67804491,2072,11678,1092880190,2022-12-31
4262c35271e8d18f,mint,1154923446,93905953,1470542,49416,1250349357,2022-12-31
653482345d47d1d4,at&t,1225969438,65597207,1504738,79988,1293151371,2022-12-31
6422bdb8f13dd4a1,at&t,1011117124,54490661,1406544,25836,1067040165,2022-12-31
1922e5a452980cf8,,155393815,2202189,0,0,157596004,2022-12-31
cb8610542c064651,,767291090,40704854,39950857,1651742,849598543,2022-12-31
77a3296fbfa5ded2,verizon ,1029062339,88569681,1184673,268627,1119085320,2022-12-31
3b61aaad8e471f9a,,423253903,3510979,0,0,426764882,2022-12-31
a95ecb139845e5d5,verizon ,629662545,24925147,65991,30159,654683842,2022-12-31
c459dd0e4fbfca70,truconnect,2018155652,87814442,7153,2453,2105979700,2022-12-31
15cc4ff09d21d27d,mint,946313008,74014537,77407,29892,1020434844,2022-12-31
f56d271f9c95fb03,globe,1975355873,81111577,0,0,2056467450,2022-12-31
79d7a5187736ce85,mint,1101682376,108464035,33247,8960,1210188618,2022-12-31
aa49aefbbbf8f900,at&t,509078362,68447520,1496139,154945,579176966,2022-12-31
68b1dc998902df91,,221890615,3122482,0,0,225013097,2022-12-31
ba7c87280098994a,t-mobile,636939105,19671614,1420421,145050,658176190,2022-12-31
20174ef7eb79e1a6,,183819094,3406558,0,0,187225652,2022-12-31
98be5d590bbc4a75,mint,953439816,58247916,36398,14000,1011738130,2022-12-31
7937a0334f5dccf8,us mobile,4634097377,81610186,33802,18476,4715759841,2022-12-31
a0718269c8d39c66,,281457979,4311143,0,0,285769122,2022-12-31
606b6cd0a50b72da,t-mobile,981141326,64958658,0,0,1046099984,2022-12-31
d73616098e93a7dc,,244919719,2449403,0,0,247369122,2022-12-31
7eb601370fa23ec0,,266486079,4987890,0,0,271473969,2022-12-31
54a9fe4b8de440b6,mint,369327332,35125221,97708,31706,404581967,2022-12-31
993120443d1d355d,verizon ,752436929,72400457,1124999,192603,826154988,2022-12-31
4c5bef6097c75759,mint,2672873265,46332921,2056392,260264,2721522842,2022-12-31
8f07a70300ba64db,verizon ,881794557,19844508,1519091,263618,903421774,2022-12-31
c05c52da16684674,cricket,1123707981,40318096,2291750,551743,1166869570,2022-12-31
184958c792d8e354,verizon ,2260960440,93687655,766280,42879,2355457254,2022-12-31
2cb2b0782a568de7,mint,860154221,75125297,806250,791978,936877746,2022-12-31
c1026ebdc1753343,,163367100,2135276,0,0,165502376,2022-12-31
13ec9bd38aa868b2,at&t,1415752921,49148658,1433669,60338,1466395586,2022-12-31
24d9050834c8a736,at&t,1912193522,44615350,1473425,48568,1958330865,2022-12-31
36c270ea7325fe95,,39726241,1762587,0,0,41488828,2022-12-31
19dda56e3f8f2db2,mint,650815341,16333255,751984,28352,667928932,2022-12-31
3a617ad69f273fee,swisscom,684203514,39410128,1430142,49922,725093706,2022-12-31
f9606d798b957632,verizon ,1586412324,32424074,745814,32795,1619615007,2022-12-31
d65e3490159129f7,verizon ,720735206,21879838,1434913,50684,744100641,2022-12-31
9becae7cbcc9e677,verizon ,1178927634,29509338,760169,269305,1209466446,2022-12-31
90faeaed99d3442f,us mobile,5578366289,83657570,1451902,49921,5663525682,2022-12-31
bf02cdecf8c275d1,,1465083351,53082718,1414,8106,1518175589,2022-12-31
faf30f9257e3c96b,us mobile,804553540,18793667,1429231,36546,824812984,2022-12-31
7262b762d8891be3,t-mobile,9531613543,144914806,730962,21289,9677280600,2022-12-31
a8b07b069d97603d,at&t,1093980600,76889413,28813,10878,1170909704,2022-12-31
d93746a84666e14d,at&t,2422443385,34908470,1514253,65921,2458932029,2022-12-31
2d2231c2d1d8a586,t-mobile,2120054532,17005788,738,2842,2137063900,2022-12-31
46fdaff43bf30415,,157876417,2203084,0,0,160079501,2022-12-31
7c541979d39fa27f,,157909762,2120870,0,0,160030632,2022-12-31
7fbd84f400767c94,,157884387,1626882,0,0,159511269,2022-12-31
6a0b2fe2f95e6276,,157817571,2033253,0,0,159850824,2022-12-31
530182dcb45db46f,,157827407,2312527,0,0,160139934,2022-12-31
d989f48005bcda4f,,157943513,1888729,0,0,159832242,2022-12-31
5c090b6ec2c1b515,t-mobile,722596202,16778960,45345,19908,739440415,2022-12-31
2e6d63e09cd271b8,,157110401,2183235,0,0,159293636,2022-12-31
3dd431b76dcd7d35,,36148,10824,0,0,46972,2022-12-31
2ac2ad81e0f1e0a7,us  mobile,1816757168,49566741,1504810,94488,1867923207,2022-12-31
cf7bc0836417613e,verizon ,9661490254,168299334,1449451,38346,9831277385,2022-12-31
2f020ef62e805f05,mint,1018070851,69601893,81176,22087,1087776007,2022-12-31
45406843cb7c1047,spectrum,2376223930,103068011,1524270,92289,2480908500,2022-12-31
bf268898916a5320,t-mobile,1149121340,73531532,1482994,76027,1224211893,2022-12-31
23b33c50209300d5,verizon ,1421802147,50346382,856615,660209,1473665353,2022-12-31
94cd9680960796c3,t-mobile,2033388365,40064159,2328619,295433,2076076576,2022-12-31
55821c3bb89fcb00,mint,198824004,8625376,2550950,871030,210871360,2022-12-31
7db7fe9dfef953e2,at&t,1868876964,68835535,303191,13314,1938029004,2022-12-31
b7c281e5992df3f2,mint,1555769957,34330398,13605,4254,1590118214,2022-12-31
f820ddd9f8448d1c,us  mobile,490724411,18191506,858889,89753,509864559,2022-12-31
52ce004a39436eea,mint,571623830,14884601,29527,10092,586548050,2022-12-31
6ab7e164c37db8a1,verizon ,1321589930,60613689,1016786,61152,1383281557,2022-12-31
133d73da54cc7b9a,mint,637007690,33966413,731940,21029,671727072,2022-12-31
361fb0520982a8fe,at&t,3558523537,58729507,1102389,160122,3618515555,2022-12-31
74057e4a39aa112e,,156335072,4184240,0,0,160519312,2022-12-31
ae6788f6447f1965,,101758141,1536164,0,0,103294305,2022-12-31
4b1b46810a608dac,t-mobile,898814521,12269693,254058,98431,911436703,2022-12-31
54910321966f1eb9,,157572291,4289016,0,0,161861307,2022-12-31
58a3421931235f72,,27937956,645350,0,0,28583306,2022-12-31
58c9cdaaa1f51525,ultra,1693275624,37411684,1600187,88899,1732376394,2022-12-31
f122f3811493161e,,154808579,4367687,0,0,159176266,2022-12-31
4b8339963ffb9a7e,t-mobile,1029607120,22023047,720565,27366,1052378098,2022-12-31
3a5ab1ee6b0e3895,,171262961,2778707,0,0,174041668,2022-12-31
541ca6a6b13bda8a,,145940230,2470253,0,0,148410483,2022-10-31
9907fbdd530b78a9,,715661586,70479656,768553,72962,786982757,2022-10-31
8290db6d975b7629,,607499316,24369424,0,0,631868740,2022-10-31
c6e15a9abdb66970,mint,531661993,58414484,1043226,82898,591202601,2022-10-31
16059c391d5756a9,,12240,12596,878603,234963,1138402,2022-10-31
66fe53b77ee9a1ac,,41946479,2053151,0,0,43999630,2022-10-31
1a6b174893171af5,mint,882615253,60957917,119,213,943573502,2022-10-31
